,Coach,TEAM,N_Seasons_TEAM,N_Seasons_Overall,RS_G_Current,RS_W_Current,RS_L_Current,RS_G_TEAM,RS_W_TEAM,RS_L_TEAM,RS_G_Overall,RS_W_Perc_Overall,P_G_Overall,P_W_Perc,Season
0,Lenny Wilkens,ATL,4,24,82,56,26,328,201,127,1946,0.55,144.0,0.4722222222222222,1996
1,M.L. Carr,BOS,2,2,82,15,67,164,48,116,164,0.293,,,1996
2,Dave Cowens,CHH,1,2,82,54,28,82,54,28,150,0.54,3.0,0.0,1996
3,Phil Jackson,CHI,8,8,82,69,13,656,483,173,656,0.736,131.0,0.732824427480916,1996
4,Mike Fratello,CLE,4,12,82,42,40,328,179,149,905,0.556,50.0,0.38,1996
5,Jim Cleamons,DAL,1,1,82,24,58,82,24,58,82,0.293,,,1996
6,Bernie Bickerstaff,DEN,3,8,13,4,9,127,59,68,572,0.495,33.0,0.36363636363636365,1996
7,Dick Motta,DEN,1,25,69,17,52,69,17,52,1952,0.479,126.0,0.4444444444444444,1996
8,Doug Collins,DET,2,5,82,54,28,164,100,64,410,0.578,38.0,0.39473684210526316,1996
9,Rick Adelman,GSW,2,8,82,30,52,164,66,98,609,0.586,69.0,0.5217391304347826,1996
10,Rudy Tomjanovich,HOU,6,6,82,57,25,440,281,159,440,0.639,81.0,0.5925925925925926,1996
11,Larry Brown,IND,4,18,82,39,43,328,190,138,1440,0.592,125.0,0.488,1996
12,Bill Fitch,LAC,3,24,82,36,46,246,82,164,1968,0.471,109.0,0.5045871559633027,1996
13,Del Harris,LAL,3,12,82,56,26,246,157,89,919,0.532,75.0,0.41333333333333333,1996
14,Pat Riley,MIA,2,15,82,61,21,164,103,61,1219,0.705,232.0,0.625,1996
15,Chris Ford,MIL,1,6,82,33,49,82,33,49,492,0.518,29.0,0.4482758620689655,1996
16,Flip Saunders,MIN,2,2,82,40,42,144,60,84,144,0.417,3.0,0.0,1996
17,John Calipari,NJN,1,1,82,26,56,82,26,56,82,0.317,,,1996
18,Jeff Van Gundy,NYK,2,2,82,57,25,105,70,35,105,0.667,18.0,0.5555555555555556,1996
19,Brian Hill,ORL,4,4,49,24,25,295,191,104,295,0.647,36.0,0.5,1996
20,Richie Adubato,ORL,1,6,33,21,12,33,21,12,367,0.346,8.0,0.25,1996
21,Johnny Davis,PHI,1,1,82,22,60,82,22,60,82,0.268,,,1996
22,Cotton Fitzsimmons,PHO,8,21,8,0,8,549,341,208,1607,0.518,84.0,0.4166666666666667,1996
23,Danny Ainge,PHO,1,1,74,40,34,74,40,34,74,0.541,5.0,0.4,1996
24,P.J. Carlesimo,POR,3,3,82,49,33,246,137,109,246,0.557,12.0,0.25,1996
25,Garry St. Jean,SAC,5,5,67,28,39,395,159,236,395,0.403,4.0,0.25,1996
26,Eddie Jordan,SAC,1,1,15,6,9,15,6,9,15,0.4,,,1996
27,Bob Hill,SAS,3,7,18,3,15,182,124,58,469,0.548,37.0,0.4594594594594595,1996
28,Gregg Popovich,SAS,1,1,64,17,47,64,17,47,64,0.266,,,1996
29,George Karl,SEA,6,10,82,57,25,452,323,129,747,0.592,84.0,0.4880952380952381,1996
30,Darrell Walker,TOR,1,1,82,30,52,82,30,52,82,0.366,,,1996
31,Jerry Sloan,UTA,9,12,82,64,18,721,483,238,936,0.616,103.0,0.5048543689320388,1996
32,Brian Winters,VAN,2,2,43,8,35,125,23,102,125,0.184,,,1996
33,Stu Jackson,VAN,1,3,39,6,33,39,6,33,136,0.426,10.0,0.4,1996
34,Jim Lynam,WSB,3,10,46,22,24,210,82,128,720,0.456,21.0,0.38095238095238093,1996
35,Bob Staak,WSB,1,1,1,0,1,1,0,1,1,0.0,,,1996
36,Bernie Bickerstaff,WSB,1,8,35,22,13,35,22,13,572,0.495,33.0,0.36363636363636365,1996
0,Lenny Wilkens,ATL,5,25,82,50,32,410,251,159,2028,0.552,148.0,0.46621621621621623,1997
1,Rick Pitino,BOS,1,3,82,36,46,82,36,46,246,0.512,13.0,0.46153846153846156,1997
2,Dave Cowens,CHH,2,3,82,51,31,164,105,59,232,0.569,12.0,0.3333333333333333,1997
3,Phil Jackson,CHI,9,9,82,62,20,738,545,193,738,0.738,152.0,0.7302631578947368,1997
4,Mike Fratello,CLE,5,13,82,47,35,410,226,184,987,0.557,54.0,0.37037037037037035,1997
5,Jim Cleamons,DAL,2,2,16,4,12,98,28,70,98,0.286,,,1997
6,Don Nelson,DAL,1,20,66,16,50,66,16,50,1546,0.561,112.0,0.45535714285714285,1997
7,Bill Hanzlik,DEN,1,1,82,11,71,82,11,71,82,0.134,,,1997
8,Doug Collins,DET,3,6,45,21,24,209,121,88,455,0.567,38.0,0.39473684210526316,1997
9,Alvin Gentry,DET,1,2,37,16,21,37,16,21,73,0.425,,,1997
10,P.J. Carlesimo,GSW,1,4,82,19,63,82,19,63,328,0.476,12.0,0.25,1997
11,Rudy Tomjanovich,HOU,7,7,82,41,41,522,322,200,522,0.617,86.0,0.5813953488372093,1997
12,Larry Bird,IND,1,1,82,58,24,82,58,24,82,0.707,16.0,0.625,1997
13,Bill Fitch,LAC,4,25,82,17,65,328,99,229,2050,0.46,109.0,0.5045871559633027,1997
14,Del Harris,LAL,4,13,82,61,21,328,218,110,1001,0.549,88.0,0.4318181818181818,1997
15,Pat Riley,MIA,3,16,82,55,27,246,158,88,1301,0.703,237.0,0.620253164556962,1997
16,Chris Ford,MIL,2,7,82,36,46,164,69,95,574,0.507,29.0,0.4482758620689655,1997
17,Flip Saunders,MIN,3,3,82,45,37,226,105,121,226,0.465,8.0,0.25,1997
18,John Calipari,NJN,2,2,82,43,39,164,69,95,164,0.421,3.0,0.0,1997
19,Jeff Van Gundy,NYK,3,3,82,43,39,187,113,74,187,0.604,28.0,0.5,1997
20,Chuck Daly,ORL,1,13,82,41,41,82,41,41,1025,0.59,122.0,0.6065573770491803,1997
21,Larry Brown,PHI,1,19,82,31,51,82,31,51,1522,0.581,125.0,0.488,1997
22,Danny Ainge,PHO,2,2,82,56,26,156,96,60,156,0.615,9.0,0.3333333333333333,1997
23,Mike Dunleavy,POR,1,7,82,46,36,82,46,36,574,0.443,27.0,0.5185185185185185,1997
24,Eddie Jordan,SAC,2,2,82,27,55,97,33,64,97,0.34,,,1997
25,Gregg Popovich,SAS,2,2,82,56,26,146,73,73,146,0.5,9.0,0.4444444444444444,1997
26,George Karl,SEA,7,11,82,61,21,534,384,150,829,0.607,94.0,0.4787234042553192,1997
27,Darrell Walker,TOR,2,2,49,11,38,131,41,90,131,0.313,,,1997
28,Butch Carter,TOR,1,1,33,5,28,33,5,28,33,0.152,,,1997
29,Jerry Sloan,UTA,10,13,82,62,20,803,545,258,1018,0.628,123.0,0.5284552845528455,1997
30,Brian Hill,VAN,1,5,82,19,63,82,19,63,377,0.557,36.0,0.5,1997
31,Bernie Bickerstaff,WAS,2,9,82,42,40,117,64,53,654,0.497,33.0,0.36363636363636365,1997
0,Lenny Wilkens,ATL,6,26,50,31,19,460,282,178,2078,0.554,157.0,0.4585987261146497,1998
1,Rick Pitino,BOS,2,4,50,19,31,132,55,77,296,0.49,13.0,0.46153846153846156,1998
2,Dave Cowens,CHH,3,4,15,4,11,179,109,70,247,0.551,12.0,0.3333333333333333,1998
3,Paul Silas,CHH,1,4,35,22,13,35,22,13,281,0.356,,,1998
4,Tim Floyd,CHI,1,1,50,13,37,50,13,37,50,0.26,,,1998
5,Mike Fratello,CLE,6,14,50,22,28,460,248,212,1037,0.552,54.0,0.37037037037037035,1998
6,Don Nelson,DAL,2,21,50,19,31,116,35,81,1596,0.555,112.0,0.45535714285714285,1998
7,Mike D'Antoni,DEN,1,1,50,14,36,50,14,36,50,0.28,,,1998
8,Alvin Gentry,DET,2,3,50,29,21,87,45,42,123,0.488,5.0,0.4,1998
9,P.J. Carlesimo,GSW,2,5,50,21,29,132,40,92,378,0.468,12.0,0.25,1998
10,Rudy Tomjanovich,HOU,8,8,50,31,19,572,353,219,572,0.617,90.0,0.5666666666666667,1998
11,Larry Bird,IND,2,2,50,33,17,132,91,41,132,0.689,29.0,0.6551724137931034,1998
12,Chris Ford,LAC,1,8,50,9,41,50,9,41,624,0.481,29.0,0.4482758620689655,1998
13,Del Harris,LAL,5,14,12,6,6,340,224,116,1013,0.549,88.0,0.4318181818181818,1998
14,Bill Bertka,LAL,2,2,1,1,0,3,2,1,3,0.667,,,1998
15,Kurt Rambis,LAL,1,1,37,24,13,37,24,13,37,0.649,8.0,0.375,1998
16,Pat Riley,MIA,4,17,50,33,17,296,191,105,1351,0.701,242.0,0.6157024793388429,1998
17,George Karl,MIL,1,12,50,28,22,50,28,22,879,0.604,97.0,0.4639175257731959,1998
18,Flip Saunders,MIN,4,4,50,25,25,276,130,146,276,0.471,12.0,0.25,1998
19,John Calipari,NJN,3,3,20,3,17,184,72,112,184,0.391,3.0,0.0,1998
20,Don Casey,NJN,1,3,30,13,17,30,13,17,156,0.346,,,1998
21,Jeff Van Gundy,NYK,4,4,50,27,23,237,140,97,237,0.591,48.0,0.5416666666666666,1998
22,Chuck Daly,ORL,2,14,50,33,17,132,74,58,1075,0.593,126.0,0.5952380952380952,1998
23,Larry Brown,PHI,2,20,50,28,22,132,59,73,1572,0.58,133.0,0.48120300751879697,1998
24,Danny Ainge,PHO,3,3,50,27,23,206,123,83,206,0.597,12.0,0.25,1998
25,Mike Dunleavy,POR,2,8,50,35,15,132,81,51,624,0.463,40.0,0.525,1998
26,Rick Adelman,SAC,1,9,50,27,23,50,27,23,659,0.583,74.0,0.5135135135135135,1998
27,Gregg Popovich,SAS,3,3,50,37,13,196,110,86,196,0.561,26.0,0.7307692307692307,1998
28,Paul Westphal,SEA,1,5,50,25,25,50,25,25,329,0.657,44.0,0.5681818181818182,1998
29,Butch Carter,TOR,2,2,50,23,27,83,28,55,83,0.337,,,1998
30,Jerry Sloan,UTA,11,14,50,37,13,853,582,271,1068,0.633,134.0,0.5223880597014925,1998
31,Brian Hill,VAN,2,6,50,8,42,132,27,105,427,0.511,36.0,0.5,1998
32,Bernie Bickerstaff,WAS,3,10,32,13,19,149,77,72,686,0.493,33.0,0.36363636363636365,1998
33,Jim Brovelli,WAS,1,1,18,5,13,18,5,13,18,0.278,,,1998
0,Lenny Wilkens,ATL,7,27,82,28,54,542,310,232,2160,0.546,157.0,0.4585987261146497,1999
1,Rick Pitino,BOS,3,5,82,35,47,214,90,124,378,0.476,13.0,0.46153846153846156,1999
2,Paul Silas,CHH,2,5,82,49,33,117,71,46,363,0.41,4.0,0.25,1999
3,Tim Floyd,CHI,2,2,82,17,65,132,30,102,132,0.227,,,1999
4,Randy Wittman,CLE,1,1,82,32,50,82,32,50,82,0.39,,,1999
5,Don Nelson,DAL,3,22,82,40,42,198,75,123,1678,0.552,112.0,0.45535714285714285,1999
6,Dan Issel,DEN,4,4,82,35,47,280,131,149,280,0.468,12.0,0.5,1999
7,Alvin Gentry,DET,3,4,58,28,30,145,73,72,181,0.486,5.0,0.4,1999
8,George Irvine,DET,1,4,24,14,10,24,14,10,208,0.327,3.0,0.0,1999
9,P.J. Carlesimo,GSW,3,6,27,6,21,159,46,113,405,0.452,12.0,0.25,1999
10,Garry St. Jean,GSW,1,6,55,13,42,55,13,42,450,0.382,4.0,0.25,1999
11,Rudy Tomjanovich,HOU,9,9,82,34,48,654,387,267,654,0.592,90.0,0.5666666666666667,1999
12,Larry Bird,IND,3,3,82,56,26,214,147,67,214,0.687,52.0,0.6153846153846154,1999
13,Chris Ford,LAC,2,9,45,11,34,95,20,75,669,0.465,29.0,0.4482758620689655,1999
14,Jim Todd,LAC,1,1,37,4,33,37,4,33,37,0.108,,,1999
15,Phil Jackson,LAL,1,10,82,67,15,82,67,15,820,0.746,175.0,0.72,1999
16,Pat Riley,MIA,5,18,82,52,30,378,243,135,1433,0.697,252.0,0.6150793650793651,1999
17,George Karl,MIL,2,13,82,42,40,132,70,62,961,0.596,102.0,0.46078431372549017,1999
18,Flip Saunders,MIN,5,5,82,50,32,358,180,178,358,0.503,16.0,0.25,1999
19,Don Casey,NJN,2,4,82,31,51,112,44,68,238,0.357,,,1999
20,Jeff Van Gundy,NYK,5,5,82,50,32,319,190,129,319,0.596,64.0,0.546875,1999
21,Doc Rivers,ORL,1,1,82,41,41,82,41,41,82,0.5,,,1999
22,Larry Brown,PHI,3,21,82,49,33,214,108,106,1654,0.581,143.0,0.4825174825174825,1999
23,Danny Ainge,PHO,4,4,20,13,7,226,136,90,226,0.602,12.0,0.25,1999
24,Scott Skiles,PHO,1,1,62,40,22,62,40,22,62,0.645,9.0,0.4444444444444444,1999
25,Mike Dunleavy,POR,3,9,82,59,23,214,140,74,706,0.493,56.0,0.5535714285714286,1999
26,Rick Adelman,SAC,2,10,82,44,38,132,71,61,741,0.578,79.0,0.5063291139240507,1999
27,Gregg Popovich,SAS,4,4,82,53,29,278,163,115,278,0.586,30.0,0.6666666666666666,1999
28,Paul Westphal,SEA,2,6,82,45,37,132,70,62,411,0.635,49.0,0.5510204081632653,1999
29,Butch Carter,TOR,3,3,82,45,37,165,73,92,165,0.442,3.0,0.0,1999
30,Jerry Sloan,UTA,12,15,82,55,27,935,637,298,1150,0.636,144.0,0.5138888888888888,1999
31,Brian Hill,VAN,3,7,22,4,18,154,31,123,449,0.494,36.0,0.5,1999
32,Lionel Hollins,VAN,1,1,60,18,42,60,18,42,60,0.3,,,1999
33,Gar Heard,WAS,1,2,44,14,30,44,14,30,97,0.237,,,1999
34,Darrell Walker,WAS,1,3,38,15,23,38,15,23,169,0.331,,,1999
0,Lon Kruger,ATL,1,1,82,25,57,82,25,57,82,0.305,,,2000
1,Rick Pitino,BOS,4,6,34,12,22,248,102,146,412,0.466,13.0,0.46153846153846156,2000
2,Jim O'Brien,BOS,1,1,48,24,24,48,24,24,48,0.5,,,2000
3,Paul Silas,CHH,3,6,82,46,36,199,117,82,445,0.438,14.0,0.5,2000
4,Tim Floyd,CHI,3,3,82,15,67,214,45,169,214,0.21,,,2000
5,Randy Wittman,CLE,2,2,82,30,52,164,62,102,164,0.378,,,2000
6,Don Nelson,DAL,4,23,82,53,29,280,128,152,1760,0.556,122.0,0.45081967213114754,2000
7,Dan Issel,DEN,5,5,82,40,42,362,171,191,362,0.472,12.0,0.5,2000
8,George Irvine,DET,2,5,82,32,50,106,46,60,290,0.345,3.0,0.0,2000
9,Dave Cowens,GSW,1,5,82,17,65,82,17,65,329,0.465,12.0,0.3333333333333333,2000
10,Rudy Tomjanovich,HOU,10,10,82,45,37,736,432,304,736,0.587,90.0,0.5666666666666667,2000
11,Isiah Thomas,IND,1,1,82,41,41,82,41,41,82,0.5,4.0,0.25,2000
12,Alvin Gentry,LAC,1,5,82,31,51,82,31,51,263,0.452,5.0,0.4,2000
13,Phil Jackson,LAL,2,11,82,56,26,164,123,41,902,0.741,191.0,0.7382198952879581,2000
14,Pat Riley,MIA,6,19,82,50,32,460,293,167,1515,0.692,255.0,0.6078431372549019,2000
15,George Karl,MIL,3,14,82,52,30,214,122,92,1043,0.599,120.0,0.475,2000
16,Flip Saunders,MIN,6,6,82,47,35,440,227,213,440,0.516,20.0,0.25,2000
17,Byron Scott,NJN,1,1,82,26,56,82,26,56,82,0.317,,,2000
18,Jeff Van Gundy,NYK,6,6,82,48,34,401,238,163,401,0.594,69.0,0.5362318840579711,2000
19,Doc Rivers,ORL,2,2,82,43,39,164,84,80,164,0.512,4.0,0.25,2000
20,Larry Brown,PHI,4,22,82,56,26,296,164,132,1736,0.586,166.0,0.4879518072289157,2000
21,Scott Skiles,PHO,2,2,82,51,31,144,91,53,144,0.632,13.0,0.38461538461538464,2000
22,Mike Dunleavy,POR,4,10,82,50,32,296,190,106,788,0.505,59.0,0.5254237288135594,2000
23,Rick Adelman,SAC,3,11,82,55,27,214,126,88,823,0.587,87.0,0.4942528735632184,2000
24,Gregg Popovich,SAS,5,5,82,58,24,360,221,139,360,0.614,43.0,0.627906976744186,2000
25,Paul Westphal,SEA,3,7,15,6,9,147,76,71,426,0.627,49.0,0.5510204081632653,2000
26,Nate McMillan,SEA,1,1,67,38,29,67,38,29,67,0.567,,,2000
27,Lenny Wilkens,TOR,1,28,82,47,35,82,47,35,2242,0.547,169.0,0.46153846153846156,2000
28,Jerry Sloan,UTA,13,16,82,53,29,1017,690,327,1232,0.636,149.0,0.5100671140939598,2000
29,Sidney Lowe,VAN,1,3,82,23,59,82,23,59,217,0.258,,,2000
30,Leonard Hamilton,WAS,1,1,82,19,63,82,19,63,82,0.232,,,2000
0,Lon Kruger,ATL,2,2,82,33,49,164,58,106,164,0.354,,,2001
1,Jim O'Brien,BOS,2,2,82,49,33,130,73,57,130,0.562,16.0,0.5625,2001
2,Paul Silas,CHH,4,7,82,44,38,281,161,120,527,0.454,23.0,0.4782608695652174,2001
3,Tim Floyd,CHI,4,4,25,4,21,239,49,190,239,0.205,,,2001
4,Bill Berry,CHI,1,1,2,0,2,2,0,2,2,0.0,,,2001
5,Bill Cartwright,CHI,1,1,55,17,38,55,17,38,55,0.309,,,2001
6,John Lucas,CLE,1,5,82,29,53,82,29,53,389,0.424,14.0,0.42857142857142855,2001
7,Don Nelson,DAL,5,24,82,57,25,362,185,177,1842,0.562,130.0,0.45384615384615384,2001
8,Dan Issel,DEN,6,6,26,9,17,388,180,208,388,0.464,12.0,0.5,2001
9,Mike Evans,DEN,1,1,56,18,38,56,18,38,56,0.321,,,2001
10,Rick Carlisle,DET,1,1,82,50,32,82,50,32,82,0.61,10.0,0.4,2001
11,Dave Cowens,GSW,2,6,23,8,15,105,25,80,352,0.457,12.0,0.3333333333333333,2001
12,Brian Winters,GSW,1,3,59,13,46,59,13,46,184,0.196,,,2001
13,Rudy Tomjanovich,HOU,11,11,82,28,54,818,460,358,818,0.562,90.0,0.5666666666666667,2001
14,Isiah Thomas,IND,2,2,82,42,40,164,83,81,164,0.506,9.0,0.3333333333333333,2001
15,Alvin Gentry,LAC,2,6,82,39,43,164,70,94,345,0.458,5.0,0.4,2001
16,Phil Jackson,LAL,3,12,82,58,24,246,181,65,984,0.738,210.0,0.7428571428571429,2001
17,Sidney Lowe,MEM,2,4,82,23,59,164,46,118,299,0.264,,,2001
18,Pat Riley,MIA,7,20,82,36,46,542,329,213,1597,0.679,255.0,0.6078431372549019,2001
19,George Karl,MIL,4,15,82,41,41,296,163,133,1125,0.592,120.0,0.475,2001
20,Flip Saunders,MIN,7,7,82,50,32,522,277,245,522,0.531,23.0,0.21739130434782608,2001
21,Byron Scott,NJN,2,2,82,52,30,164,78,86,164,0.476,20.0,0.55,2001
22,Jeff Van Gundy,NYK,7,7,19,10,9,420,248,172,420,0.59,69.0,0.5362318840579711,2001
23,Don Chaney,NYK,1,10,63,20,43,63,20,43,710,0.401,11.0,0.18181818181818182,2001
24,Doc Rivers,ORL,3,3,82,44,38,246,128,118,246,0.52,8.0,0.25,2001
25,Larry Brown,PHI,5,23,82,43,39,378,207,171,1818,0.583,171.0,0.4853801169590643,2001
26,Scott Skiles,PHO,3,3,51,25,26,195,116,79,195,0.595,13.0,0.38461538461538464,2001
27,Frank Johnson,PHO,1,1,31,11,20,31,11,20,31,0.355,,,2001
28,Maurice Cheeks,POR,1,1,82,49,33,82,49,33,82,0.598,3.0,0.0,2001
29,Rick Adelman,SAC,4,12,82,61,21,296,187,109,905,0.601,103.0,0.5145631067961165,2001
30,Gregg Popovich,SAS,6,6,82,58,24,442,279,163,442,0.631,53.0,0.5849056603773585,2001
31,Nate McMillan,SEA,2,2,82,45,37,149,83,66,149,0.557,5.0,0.4,2001
32,Lenny Wilkens,TOR,2,29,82,42,40,164,89,75,2324,0.546,174.0,0.45977011494252873,2001
33,Jerry Sloan,UTA,14,17,82,44,38,1099,734,365,1314,0.63,153.0,0.5032679738562091,2001
34,Doug Collins,WAS,1,7,82,37,45,82,37,45,537,0.549,38.0,0.39473684210526316,2001
0,Lon Kruger,ATL,3,3,27,11,16,191,69,122,191,0.361,,,2002
1,Terry Stotts,ATL,1,1,55,24,31,55,24,31,55,0.436,,,2002
2,Jim O'Brien,BOS,3,3,82,44,38,212,117,95,212,0.552,26.0,0.5,2002
3,Bill Cartwright,CHI,2,2,82,30,52,137,47,90,137,0.343,,,2002
4,John Lucas,CLE,2,6,42,8,34,124,37,87,431,0.401,14.0,0.42857142857142855,2002
5,Keith Smart,CLE,1,1,40,9,31,40,9,31,40,0.225,,,2002
6,Don Nelson,DAL,6,25,82,60,22,444,245,199,1924,0.57,150.0,0.46,2002
7,Jeff Bzdelik,DEN,1,1,82,17,65,82,17,65,82,0.207,,,2002
8,Rick Carlisle,DET,2,2,82,50,32,164,100,64,164,0.61,27.0,0.4444444444444444,2002
9,Eric Musselman,GSW,1,1,82,38,44,82,38,44,82,0.463,,,2002
10,Rudy Tomjanovich,HOU,12,12,82,43,39,900,503,397,900,0.559,90.0,0.5666666666666667,2002
11,Isiah Thomas,IND,3,3,82,48,34,246,131,115,246,0.533,15.0,0.3333333333333333,2002
12,Alvin Gentry,LAC,3,7,58,19,39,222,89,133,403,0.439,5.0,0.4,2002
13,Dennis Johnson,LAC,1,1,24,8,16,24,8,16,24,0.333,,,2002
14,Phil Jackson,LAL,4,13,82,50,32,328,231,97,1066,0.728,222.0,0.7297297297297297,2002
15,Sidney Lowe,MEM,3,5,8,0,8,172,46,126,307,0.257,,,2002
16,Hubie Brown,MEM,1,13,74,28,46,74,28,46,993,0.476,59.0,0.5254237288135594,2002
17,Pat Riley,MIA,8,21,82,25,57,624,354,270,1679,0.661,255.0,0.6078431372549019,2002
18,George Karl,MIL,5,16,82,42,40,378,205,173,1207,0.587,126.0,0.46825396825396826,2002
19,Flip Saunders,MIN,8,8,82,51,31,604,328,276,604,0.543,29.0,0.2413793103448276,2002
20,Byron Scott,NJN,3,3,82,49,33,246,127,119,246,0.516,40.0,0.625,2002
21,Paul Silas,NOH,1,8,82,47,35,82,47,35,609,0.47,29.0,0.4482758620689655,2002
22,Don Chaney,NYK,2,11,82,37,45,145,57,88,792,0.407,11.0,0.18181818181818182,2002
23,Doc Rivers,ORL,4,4,82,42,40,328,170,158,328,0.518,15.0,0.3333333333333333,2002
24,Larry Brown,PHI,6,24,82,48,34,460,255,205,1900,0.583,183.0,0.48633879781420764,2002
25,Frank Johnson,PHO,2,2,82,44,38,113,55,58,113,0.487,6.0,0.3333333333333333,2002
26,Maurice Cheeks,POR,2,2,82,50,32,164,99,65,164,0.604,10.0,0.3,2002
27,Rick Adelman,SAC,5,13,82,59,23,378,246,132,987,0.611,115.0,0.5217391304347826,2002
28,Gregg Popovich,SAS,7,7,82,60,22,524,339,185,524,0.647,77.0,0.6103896103896104,2002
29,Nate McMillan,SEA,3,3,82,40,42,231,123,108,231,0.532,5.0,0.4,2002
30,Lenny Wilkens,TOR,3,30,82,24,58,246,113,133,2406,0.537,174.0,0.45977011494252873,2002
31,Jerry Sloan,UTA,15,18,82,47,35,1181,781,400,1396,0.627,158.0,0.4936708860759494,2002
32,Doug Collins,WAS,2,8,82,37,45,164,74,90,619,0.536,38.0,0.39473684210526316,2002
0,Terry Stotts,ATL,2,2,82,28,54,137,52,85,137,0.38,,,2003
1,Jim O'Brien,BOS,4,4,46,22,24,258,139,119,258,0.539,26.0,0.5,2003
2,John Carroll,BOS,1,1,36,14,22,36,14,22,36,0.389,4.0,0.0,2003
3,Bill Cartwright,CHI,3,3,14,4,10,151,51,100,151,0.338,,,2003
4,Pete Myers,CHI,1,1,2,0,2,2,0,2,2,0.0,,,2003
5,Scott Skiles,CHI,1,4,66,19,47,66,19,47,261,0.517,13.0,0.38461538461538464,2003
6,Paul Silas,CLE,1,9,82,35,47,82,35,47,691,0.465,29.0,0.4482758620689655,2003
7,Don Nelson,DAL,7,26,82,52,30,526,297,229,2006,0.572,155.0,0.45161290322580644,2003
8,Jeff Bzdelik,DEN,2,2,82,43,39,164,60,104,164,0.366,5.0,0.2,2003
9,Larry Brown,DET,1,25,82,54,28,82,54,28,1982,0.586,206.0,0.5097087378640777,2003
10,Eric Musselman,GSW,2,2,82,37,45,164,75,89,164,0.457,,,2003
11,Jeff Van Gundy,HOU,1,8,82,45,37,82,45,37,502,0.584,74.0,0.5135135135135135,2003
12,Rick Carlisle,IND,1,3,82,61,21,82,61,21,246,0.654,43.0,0.5116279069767442,2003
13,Mike Dunleavy,LAC,1,11,82,28,54,82,28,54,870,0.49,59.0,0.5254237288135594,2003
14,Phil Jackson,LAL,5,14,82,56,26,410,287,123,1148,0.725,244.0,0.7172131147540983,2003
15,Hubie Brown,MEM,2,14,82,50,32,156,78,78,1075,0.487,63.0,0.49206349206349204,2003
16,Stan Van Gundy,MIA,1,1,82,42,40,82,42,40,82,0.512,13.0,0.46153846153846156,2003
17,Terry Porter,MIL,1,1,82,41,41,82,41,41,82,0.5,5.0,0.2,2003
18,Flip Saunders,MIN,9,9,82,58,24,686,386,300,686,0.563,47.0,0.3617021276595745,2003
19,Byron Scott,NJN,4,4,42,22,20,288,149,139,288,0.517,40.0,0.625,2003
20,Lawrence Frank,NJN,1,1,40,25,15,40,25,15,40,0.625,11.0,0.6363636363636364,2003
21,Tim Floyd,NOH,1,5,82,41,41,82,41,41,321,0.28,7.0,0.42857142857142855,2003
22,Don Chaney,NYK,3,12,39,15,24,184,72,112,831,0.406,11.0,0.18181818181818182,2003
23,Herb Williams,NYK,1,1,1,1,0,1,1,0,1,1.0,,,2003
24,Lenny Wilkens,NYK,1,31,42,23,19,42,23,19,2448,0.537,178.0,0.449438202247191,2003
25,Doc Rivers,ORL,5,5,11,1,10,339,171,168,339,0.504,15.0,0.3333333333333333,2003
26,Johnny Davis,ORL,1,2,71,20,51,71,20,51,153,0.275,,,2003
27,Randy Ayers,PHI,1,1,52,21,31,52,21,31,52,0.404,,,2003
28,Chris Ford,PHI,1,10,30,12,18,30,12,18,699,0.462,29.0,0.4482758620689655,2003
29,Frank Johnson,PHO,3,3,21,8,13,134,63,71,134,0.47,6.0,0.3333333333333333,2003
30,Mike D'Antoni,PHO,1,2,61,21,40,61,21,40,111,0.315,,,2003
31,Maurice Cheeks,POR,3,3,82,41,41,246,140,106,246,0.569,10.0,0.3,2003
32,Rick Adelman,SAC,6,14,82,55,27,460,301,159,1069,0.616,127.0,0.5275590551181102,2003
33,Gregg Popovich,SAS,8,8,82,57,25,606,396,210,606,0.653,87.0,0.6091954022988506,2003
34,Nate McMillan,SEA,4,4,82,37,45,313,160,153,313,0.511,5.0,0.4,2003
35,Kevin O'Neill,TOR,1,1,82,33,49,82,33,49,82,0.402,,,2003
36,Jerry Sloan,UTA,16,19,82,42,40,1263,823,440,1478,0.62,158.0,0.4936708860759494,2003
37,Eddie Jordan,WAS,1,3,82,25,57,82,25,57,179,0.324,,,2003
0,Mike Woodson,ATL,1,1,82,13,69,82,13,69,82,0.159,,,2004
1,Doc Rivers,BOS,1,6,82,45,37,82,45,37,421,0.513,22.0,0.36363636363636365,2004
2,Bernie Bickerstaff,CHA,1,11,82,18,64,82,18,64,768,0.464,33.0,0.36363636363636365,2004
3,Scott Skiles,CHI,2,5,82,47,35,148,66,82,343,0.531,19.0,0.3684210526315789,2004
4,Paul Silas,CLE,2,10,64,34,30,146,69,77,755,0.47,29.0,0.4482758620689655,2004
5,Brendan Malone,CLE,1,2,18,8,10,18,8,10,100,0.29,,,2004
6,Don Nelson,DAL,8,27,64,42,22,590,339,251,2070,0.575,155.0,0.45161290322580644,2004
7,Avery Johnson,DAL,1,1,18,16,2,18,16,2,18,0.889,13.0,0.46153846153846156,2004
8,Jeff Bzdelik,DEN,3,3,28,13,15,192,73,119,192,0.38,5.0,0.2,2004
9,Michael Cooper,DEN,1,1,14,4,10,14,4,10,14,0.286,,,2004
10,George Karl,DEN,1,17,40,32,8,40,32,8,1247,0.593,131.0,0.4580152671755725,2004
11,Larry Brown,DET,2,26,82,54,28,164,108,56,2064,0.589,231.0,0.5194805194805194,2004
12,Mike Montgomery,GSW,1,1,82,34,48,82,34,48,82,0.415,,,2004
13,Jeff Van Gundy,HOU,2,9,82,51,31,164,96,68,584,0.589,81.0,0.5061728395061729,2004
14,Rick Carlisle,IND,2,4,82,44,38,164,105,59,328,0.625,56.0,0.5,2004
15,Mike Dunleavy,LAC,2,12,82,37,45,164,65,99,952,0.486,59.0,0.5254237288135594,2004
16,Rudy Tomjanovich,LAL,1,13,43,24,19,43,24,19,943,0.559,90.0,0.5666666666666667,2004
17,Frank Hamblen,LAL,1,2,39,10,29,39,10,29,104,0.317,,,2004
18,Hubie Brown,MEM,3,15,12,5,7,168,83,85,1087,0.486,63.0,0.49206349206349204,2004
19,Lionel Hollins,MEM,2,2,4,0,4,64,18,46,64,0.281,,,2004
20,Mike Fratello,MEM,1,15,66,40,26,66,40,26,1103,0.555,58.0,0.3448275862068966,2004
21,Stan Van Gundy,MIA,2,2,82,59,23,164,101,63,164,0.616,28.0,0.6071428571428571,2004
22,Terry Porter,MIL,2,2,82,30,52,164,71,93,164,0.433,5.0,0.2,2004
23,Flip Saunders,MIN,10,10,51,25,26,737,411,326,737,0.558,47.0,0.3617021276595745,2004
24,Kevin McHale,MIN,1,1,31,19,12,31,19,12,31,0.613,,,2004
25,Lawrence Frank,NJN,2,2,82,42,40,122,67,55,122,0.549,15.0,0.4666666666666667,2004
26,Byron Scott,NOH,1,5,82,18,64,82,18,64,370,0.451,40.0,0.625,2004
27,Lenny Wilkens,NYK,2,32,39,17,22,81,40,41,2487,0.536,178.0,0.449438202247191,2004
28,Herb Williams,NYK,2,2,43,16,27,44,17,27,44,0.386,,,2004
29,Johnny Davis,ORL,2,3,64,31,33,135,51,84,217,0.336,,,2004
30,Chris Jent,ORL,1,1,18,5,13,18,5,13,18,0.278,,,2004
31,Jim O'Brien,PHI,1,5,82,43,39,82,43,39,340,0.535,31.0,0.45161290322580644,2004
32,Mike D'Antoni,PHO,2,3,82,62,20,143,83,60,193,0.503,15.0,0.6,2004
33,Maurice Cheeks,POR,4,4,55,22,33,301,162,139,301,0.538,10.0,0.3,2004
34,Kevin Pritchard,POR,1,1,27,5,22,27,5,22,27,0.185,,,2004
35,Rick Adelman,SAC,7,15,82,50,32,542,351,191,1151,0.615,132.0,0.5151515151515151,2004
36,Gregg Popovich,SAS,9,9,82,59,23,688,455,233,688,0.661,110.0,0.6272727272727273,2004
37,Nate McMillan,SEA,5,5,82,52,30,395,212,183,395,0.537,16.0,0.5,2004
38,Sam Mitchell,TOR,1,1,82,33,49,82,33,49,82,0.402,,,2004
39,Jerry Sloan,UTA,17,20,82,26,56,1345,849,496,1560,0.604,158.0,0.4936708860759494,2004
40,Eddie Jordan,WAS,2,4,82,45,37,164,70,94,261,0.395,10.0,0.4,2004
0,Mike Woodson,ATL,2,2,82,26,56,164,39,125,164,0.238,,,2005
1,Doc Rivers,BOS,2,7,82,33,49,164,78,86,503,0.495,22.0,0.36363636363636365,2005
2,Bernie Bickerstaff,CHA,2,12,82,26,56,164,44,120,850,0.449,33.0,0.36363636363636365,2005
3,Scott Skiles,CHI,3,6,82,41,41,230,107,123,425,0.525,25.0,0.36,2005
4,Mike Brown,CLE,1,1,82,50,32,82,50,32,82,0.61,13.0,0.5384615384615384,2005
5,Avery Johnson,DAL,2,2,82,60,22,100,76,24,100,0.76,36.0,0.5555555555555556,2005
6,George Karl,DEN,2,18,82,44,38,122,76,46,1329,0.59,136.0,0.4485294117647059,2005
7,Flip Saunders,DET,1,11,82,64,18,82,64,18,819,0.58,65.0,0.4153846153846154,2005
8,Mike Montgomery,GSW,2,2,82,34,48,164,68,96,164,0.415,,,2005
9,Jeff Van Gundy,HOU,3,10,82,34,48,246,130,116,666,0.568,81.0,0.5061728395061729,2005
10,Rick Carlisle,IND,3,5,82,41,41,246,146,100,410,0.6,62.0,0.4838709677419355,2005
11,Mike Dunleavy,LAC,3,13,82,47,35,246,112,134,1034,0.493,71.0,0.5352112676056338,2005
12,Phil Jackson,LAL,6,15,82,45,37,492,332,160,1230,0.713,251.0,0.7091633466135459,2005
13,Mike Fratello,MEM,2,16,82,49,33,148,89,59,1185,0.558,62.0,0.3225806451612903,2005
14,Stan Van Gundy,MIA,3,3,21,11,10,185,112,73,185,0.605,28.0,0.6071428571428571,2005
15,Pat Riley,MIA,9,22,61,41,20,685,395,290,1740,0.661,278.0,0.6151079136690647,2005
16,Terry Stotts,MIL,1,3,82,40,42,82,40,42,219,0.42,5.0,0.2,2005
17,Dwane Casey,MIN,1,1,82,33,49,82,33,49,82,0.402,,,2005
18,Lawrence Frank,NJN,3,3,82,49,33,204,116,88,204,0.569,26.0,0.46153846153846156,2005
19,Byron Scott,NOK,2,6,82,38,44,164,56,108,452,0.454,40.0,0.625,2005
20,Larry Brown,NYK,1,27,82,23,59,82,23,59,2146,0.577,231.0,0.5194805194805194,2005
21,Brian Hill,ORL,5,8,82,36,46,377,227,150,531,0.486,36.0,0.5,2005
22,Maurice Cheeks,PHI,1,5,82,38,44,82,38,44,383,0.522,10.0,0.3,2005
23,Mike D'Antoni,PHO,3,4,82,54,28,225,137,88,275,0.549,35.0,0.5428571428571428,2005
24,Nate McMillan,POR,1,6,82,21,61,82,21,61,477,0.488,16.0,0.5,2005
25,Rick Adelman,SAC,8,16,82,44,38,624,395,229,1233,0.61,138.0,0.5072463768115942,2005
26,Gregg Popovich,SAS,10,10,82,63,19,770,518,252,770,0.673,123.0,0.6178861788617886,2005
27,Bob Weiss,SEA,1,7,30,13,17,30,13,17,522,0.427,11.0,0.18181818181818182,2005
28,Bob Hill,SEA,1,8,52,22,30,52,22,30,521,0.536,37.0,0.4594594594594595,2005
29,Sam Mitchell,TOR,2,2,82,27,55,164,60,104,164,0.366,,,2005
30,Jerry Sloan,UTA,18,21,82,41,41,1427,890,537,1642,0.599,158.0,0.4936708860759494,2005
31,Eddie Jordan,WAS,3,5,82,42,40,246,112,134,343,0.423,16.0,0.375,2005
0,Mike Woodson,ATL,3,3,82,30,52,246,69,177,246,0.28,,,2006
1,Doc Rivers,BOS,3,8,82,24,58,246,102,144,585,0.467,22.0,0.36363636363636365,2006
2,Bernie Bickerstaff,CHA,3,13,82,33,49,246,77,169,932,0.445,33.0,0.36363636363636365,2006
3,Scott Skiles,CHI,4,7,82,49,33,312,156,156,507,0.536,35.0,0.42857142857142855,2006
4,Mike Brown,CLE,2,2,82,50,32,164,100,64,164,0.61,33.0,0.5757575757575758,2006
5,Avery Johnson,DAL,3,3,82,67,15,182,143,39,182,0.786,42.0,0.5238095238095238,2006
6,George Karl,DEN,3,19,82,45,37,204,121,83,1411,0.588,141.0,0.4397163120567376,2006
7,Flip Saunders,DET,2,12,82,53,29,164,117,47,901,0.586,81.0,0.4567901234567901,2006
8,Don Nelson,GSW,8,28,82,42,40,619,319,300,2152,0.572,166.0,0.45180722891566266,2006
9,Jeff Van Gundy,HOU,4,11,82,52,30,328,182,146,748,0.575,88.0,0.5,2006
10,Rick Carlisle,IND,4,6,82,35,47,328,181,147,492,0.571,62.0,0.4838709677419355,2006
11,Mike Dunleavy,LAC,4,14,82,40,42,328,152,176,1116,0.493,71.0,0.5352112676056338,2006
12,Phil Jackson,LAL,7,16,82,42,40,574,374,200,1312,0.7,256.0,0.69921875,2006
13,Mike Fratello,MEM,3,17,30,6,24,178,95,83,1215,0.549,62.0,0.3225806451612903,2006
14,Tony Barone,MEM,1,1,52,16,36,52,16,36,52,0.308,,,2006
15,Pat Riley,MIA,10,23,82,44,38,767,439,328,1822,0.656,282.0,0.6063829787234043,2006
16,Terry Stotts,MIL,2,4,64,23,41,146,63,83,283,0.406,5.0,0.2,2006
17,Larry Krystkowiak,MIL,1,1,18,5,13,18,5,13,18,0.278,,,2006
18,Dwane Casey,MIN,2,2,40,20,20,122,53,69,122,0.434,,,2006
19,Randy Wittman,MIN,1,3,42,12,30,42,12,30,206,0.359,,,2006
20,Lawrence Frank,NJN,4,4,82,41,41,286,157,129,286,0.549,38.0,0.47368421052631576,2006
21,Byron Scott,NOK,3,7,82,39,43,246,95,151,534,0.457,40.0,0.625,2006
22,Isiah Thomas,NYK,1,4,82,33,49,82,33,49,328,0.5,15.0,0.3333333333333333,2006
23,Brian Hill,ORL,6,9,82,40,42,459,267,192,613,0.486,40.0,0.45,2006
24,Maurice Cheeks,PHI,2,6,82,35,47,164,73,91,465,0.505,10.0,0.3,2006
25,Mike D'Antoni,PHO,4,5,82,61,21,307,198,109,357,0.594,46.0,0.5434782608695652,2006
26,Nate McMillan,POR,2,7,82,32,50,164,53,111,559,0.474,16.0,0.5,2006
27,Eric Musselman,SAC,1,3,82,33,49,82,33,49,246,0.439,,,2006
28,Gregg Popovich,SAS,11,11,82,58,24,852,576,276,852,0.676,143.0,0.6433566433566433,2006
29,Bob Hill,SEA,2,9,82,31,51,134,53,81,603,0.514,37.0,0.4594594594594595,2006
30,Sam Mitchell,TOR,3,3,82,47,35,246,107,139,246,0.435,6.0,0.3333333333333333,2006
31,Jerry Sloan,UTA,19,22,82,51,31,1509,941,568,1724,0.6,175.0,0.49714285714285716,2006
32,Eddie Jordan,WAS,4,6,82,41,41,328,153,175,425,0.438,20.0,0.3,2006
0,Mike Woodson,ATL,4,4,82,37,45,328,106,222,328,0.323,7.0,0.42857142857142855,2007
1,Doc Rivers,BOS,4,9,82,66,16,328,168,160,667,0.508,48.0,0.5,2007
2,Sam Vincent,CHA,1,1,82,32,50,82,32,50,82,0.39,,,2007
3,Scott Skiles,CHI,5,8,25,9,16,337,165,172,532,0.528,35.0,0.42857142857142855,2007
4,Pete Myers,CHI,2,2,1,0,1,3,0,3,3,0.0,,,2007
5,Jim Boylan,CHI,1,1,56,24,32,56,24,32,56,0.429,,,2007
6,Mike Brown,CLE,3,3,82,45,37,246,145,101,246,0.589,46.0,0.5652173913043478,2007
7,Avery Johnson,DAL,4,4,82,51,31,264,194,70,264,0.735,47.0,0.48936170212765956,2007
8,George Karl,DEN,4,20,82,50,32,286,171,115,1493,0.589,145.0,0.42758620689655175,2007
9,Flip Saunders,DET,3,13,82,59,23,246,176,70,983,0.597,98.0,0.47959183673469385,2007
10,Don Nelson,GSW,9,29,82,48,34,701,367,334,2234,0.573,166.0,0.45180722891566266,2007
11,Rick Adelman,HOU,1,17,82,55,27,82,55,27,1315,0.614,144.0,0.5,2007
12,Jim O'Brien,IND,1,6,82,36,46,82,36,46,422,0.517,31.0,0.45161290322580644,2007
13,Mike Dunleavy,LAC,5,15,82,23,59,410,175,235,1198,0.478,71.0,0.5352112676056338,2007
14,Phil Jackson,LAL,8,17,82,57,25,656,431,225,1394,0.7,277.0,0.6967509025270758,2007
15,Marc Iavaroni,MEM,1,1,82,22,60,82,22,60,82,0.268,,,2007
16,Pat Riley,MIA,11,24,82,15,67,849,454,395,1904,0.636,282.0,0.6063829787234043,2007
17,Larry Krystkowiak,MIL,2,2,82,26,56,100,31,69,100,0.31,,,2007
18,Randy Wittman,MIN,2,4,82,22,60,124,34,90,288,0.333,,,2007
19,Lawrence Frank,NJN,5,5,82,34,48,368,191,177,368,0.519,38.0,0.47368421052631576,2007
20,Byron Scott,NOH,4,8,82,56,26,328,151,177,616,0.487,52.0,0.6153846153846154,2007
21,Isiah Thomas,NYK,2,5,82,23,59,164,56,108,410,0.456,15.0,0.3333333333333333,2007
22,Stan Van Gundy,ORL,1,4,82,52,30,82,52,30,267,0.614,38.0,0.5789473684210527,2007
23,Maurice Cheeks,PHI,3,7,82,40,42,246,113,133,547,0.503,16.0,0.3125,2007
24,Mike D'Antoni,PHO,5,6,82,55,27,389,253,136,439,0.608,51.0,0.5098039215686274,2007
25,Nate McMillan,POR,3,8,82,41,41,246,94,152,641,0.477,16.0,0.5,2007
26,Reggie Theus,SAC,1,1,82,38,44,82,38,44,82,0.463,,,2007
27,Gregg Popovich,SAS,12,12,82,56,26,934,632,302,934,0.677,160.0,0.63125,2007
28,P.J. Carlesimo,SEA,1,7,82,20,62,82,20,62,487,0.417,12.0,0.25,2007
29,Sam Mitchell,TOR,4,4,82,41,41,328,148,180,328,0.451,11.0,0.2727272727272727,2007
30,Jerry Sloan,UTA,20,23,82,54,28,1591,995,596,1806,0.603,187.0,0.49732620320855614,2007
31,Eddie Jordan,WAS,5,7,82,43,39,410,196,214,507,0.452,26.0,0.3076923076923077,2007
0,Mike Woodson,ATL,5,5,82,47,35,410,153,257,410,0.373,18.0,0.3888888888888889,2008
1,Doc Rivers,BOS,5,10,82,62,20,410,230,180,749,0.535,62.0,0.5,2008
2,Larry Brown,CHA,1,28,82,35,47,82,35,47,2228,0.572,231.0,0.5194805194805194,2008
3,Vinny Del Negro,CHI,1,1,82,41,41,82,41,41,82,0.5,7.0,0.42857142857142855,2008
4,Mike Brown,CLE,4,4,82,66,16,328,211,117,328,0.643,60.0,0.6,2008
5,Rick Carlisle,DAL,1,7,82,50,32,82,50,32,574,0.577,72.0,0.4861111111111111,2008
6,George Karl,DEN,5,21,82,54,28,368,225,143,1575,0.592,161.0,0.4472049689440994,2008
7,Michael Curry,DET,1,1,82,39,43,82,39,43,82,0.476,4.0,0.0,2008
8,Don Nelson,GSW,10,30,82,29,53,783,396,387,2316,0.565,166.0,0.45180722891566266,2008
9,Rick Adelman,HOU,2,18,82,53,29,164,108,56,1397,0.616,157.0,0.5031847133757962,2008
10,Jim O'Brien,IND,2,7,82,36,46,164,72,92,504,0.504,31.0,0.45161290322580644,2008
11,Mike Dunleavy,LAC,6,16,82,19,63,492,194,298,1280,0.463,71.0,0.5352112676056338,2008
12,Phil Jackson,LAL,9,18,82,65,17,738,496,242,1476,0.705,300.0,0.6966666666666667,2008
13,Marc Iavaroni,MEM,2,2,41,11,30,123,33,90,123,0.268,,,2008
14,Johnny Davis,MEM,1,4,2,0,2,2,0,2,219,0.333,,,2008
15,Lionel Hollins,MEM,3,3,39,13,26,103,31,72,103,0.301,,,2008
16,Erik Spoelstra,MIA,1,1,82,43,39,82,43,39,82,0.524,7.0,0.42857142857142855,2008
17,Scott Skiles,MIL,1,9,82,34,48,82,34,48,614,0.513,35.0,0.42857142857142855,2008
18,Randy Wittman,MIN,3,5,19,4,15,143,38,105,307,0.326,,,2008
19,Kevin McHale,MIN,2,2,63,20,43,94,39,55,94,0.415,,,2008
20,Lawrence Frank,NJN,6,6,82,34,48,450,225,225,450,0.5,38.0,0.47368421052631576,2008
21,Byron Scott,NOH,5,9,82,49,33,410,200,210,698,0.5,57.0,0.5789473684210527,2008
22,Mike D'Antoni,NYK,1,7,82,32,50,82,32,50,521,0.574,51.0,0.5098039215686274,2008
23,P.J. Carlesimo,OKC,2,8,13,1,12,95,21,74,500,0.408,12.0,0.25,2008
24,Scott Brooks,OKC,1,1,69,22,47,69,22,47,69,0.319,,,2008
25,Stan Van Gundy,ORL,2,5,82,59,23,164,111,53,349,0.639,62.0,0.5645161290322581,2008
26,Maurice Cheeks,PHI,4,8,23,9,14,269,122,147,570,0.498,16.0,0.3125,2008
27,Tony DiLeo,PHI,1,1,59,32,27,59,32,27,59,0.542,6.0,0.3333333333333333,2008
28,Terry Porter,PHO,1,3,51,28,23,51,28,23,215,0.46,5.0,0.2,2008
29,Alvin Gentry,PHO,1,8,31,18,13,31,18,13,434,0.449,5.0,0.4,2008
30,Nate McMillan,POR,4,9,82,54,28,328,148,180,723,0.498,22.0,0.45454545454545453,2008
31,Reggie Theus,SAC,2,2,24,6,18,106,44,62,106,0.415,,,2008
32,Kenny Natt,SAC,1,1,58,11,47,58,11,47,58,0.19,,,2008
33,Gregg Popovich,SAS,13,13,82,54,28,1016,686,330,1016,0.675,165.0,0.6181818181818182,2008
34,Sam Mitchell,TOR,5,5,17,8,9,345,156,189,345,0.452,11.0,0.2727272727272727,2008
35,Jay Triano,TOR,1,1,65,25,40,65,25,40,65,0.385,,,2008
36,Jerry Sloan,UTA,21,24,82,48,34,1673,1043,630,1888,0.602,192.0,0.4895833333333333,2008
37,Eddie Jordan,WAS,6,8,11,1,10,421,197,224,518,0.444,26.0,0.3076923076923077,2008
38,Ed Tapscott,WAS,1,1,71,18,53,71,18,53,71,0.254,,,2008
0,Mike Woodson,ATL,6,6,82,53,29,492,206,286,492,0.419,29.0,0.3793103448275862,2009
1,Doc Rivers,BOS,6,11,82,50,32,492,280,212,831,0.543,86.0,0.5348837209302325,2009
2,Larry Brown,CHA,2,29,82,44,38,164,79,85,2310,0.571,235.0,0.5106382978723404,2009
3,Vinny Del Negro,CHI,2,2,82,41,41,164,82,82,164,0.5,12.0,0.3333333333333333,2009
4,Mike Brown,CLE,5,5,82,61,21,410,272,138,410,0.663,71.0,0.5915492957746479,2009
5,Rick Carlisle,DAL,2,8,82,55,27,164,105,59,656,0.588,78.0,0.47435897435897434,2009
6,George Karl,DEN,6,22,82,53,29,450,278,172,1657,0.595,167.0,0.4431137724550898,2009
7,John Kuester,DET,1,1,82,27,55,82,27,55,82,0.329,,,2009
8,Don Nelson,GSW,11,31,82,26,56,865,422,443,2398,0.557,166.0,0.45180722891566266,2009
9,Rick Adelman,HOU,3,19,82,42,40,246,150,96,1479,0.61,157.0,0.5031847133757962,2009
10,Jim O'Brien,IND,3,8,82,32,50,246,104,142,586,0.488,31.0,0.45161290322580644,2009
11,Mike Dunleavy,LAC,7,17,49,21,28,541,215,326,1329,0.461,71.0,0.5352112676056338,2009
12,Kim Hughes,LAC,1,1,33,8,25,33,8,25,33,0.242,,,2009
13,Phil Jackson,LAL,10,19,82,57,25,820,553,267,1558,0.705,323.0,0.6965944272445821,2009
14,Lionel Hollins,MEM,4,4,82,40,42,185,71,114,185,0.384,,,2009
15,Erik Spoelstra,MIA,2,2,82,47,35,164,90,74,164,0.549,12.0,0.3333333333333333,2009
16,Scott Skiles,MIL,2,10,82,46,36,164,80,84,696,0.519,42.0,0.42857142857142855,2009
17,Kurt Rambis,MIN,1,2,82,15,67,82,15,67,119,0.328,8.0,0.375,2009
18,Lawrence Frank,NJN,7,7,16,0,16,466,225,241,466,0.483,38.0,0.47368421052631576,2009
19,Tom Barrise,NJN,1,1,2,0,2,2,0,2,2,0.0,,,2009
20,Kiki Vandeweghe,NJN,1,1,64,12,52,64,12,52,64,0.188,,,2009
21,Byron Scott,NOH,6,10,9,3,6,419,203,216,707,0.498,57.0,0.5789473684210527,2009
22,Jeff Bower,NOH,1,1,73,34,39,73,34,39,73,0.466,,,2009
23,Mike D'Antoni,NYK,2,8,82,29,53,164,61,103,603,0.544,51.0,0.5098039215686274,2009
24,Scott Brooks,OKC,2,2,82,50,32,151,72,79,151,0.477,6.0,0.3333333333333333,2009
25,Stan Van Gundy,ORL,3,6,82,59,23,246,170,76,431,0.654,76.0,0.5921052631578947,2009
26,Eddie Jordan,PHI,1,9,82,27,55,82,27,55,600,0.428,26.0,0.3076923076923077,2009
27,Alvin Gentry,PHO,2,9,82,54,28,113,72,41,516,0.483,21.0,0.5714285714285714,2009
28,Nate McMillan,POR,5,10,82,50,32,410,198,212,805,0.509,28.0,0.42857142857142855,2009
29,Paul Westphal,SAC,1,8,82,25,57,82,25,57,508,0.575,49.0,0.5510204081632653,2009
30,Gregg Popovich,SAS,14,14,82,50,32,1098,736,362,1098,0.67,175.0,0.6057142857142858,2009
31,Jay Triano,TOR,2,2,82,40,42,147,65,82,147,0.442,,,2009
32,Jerry Sloan,UTA,22,25,82,53,29,1755,1096,659,1970,0.604,202.0,0.48514851485148514,2009
33,Flip Saunders,WAS,1,14,82,26,56,82,26,56,1065,0.576,98.0,0.47959183673469385,2009
0,Larry Drew,ATL,1,1,82,44,38,82,44,38,82,0.537,12.0,0.5,2010
1,Doc Rivers,BOS,7,12,82,56,26,574,336,238,913,0.555,95.0,0.5368421052631579,2010
2,Larry Brown,CHA,3,30,28,9,19,192,88,104,2338,0.568,235.0,0.5106382978723404,2010
3,Paul Silas,CHA,5,11,54,25,29,335,186,149,809,0.47,29.0,0.4482758620689655,2010
4,Tom Thibodeau,CHI,1,1,82,62,20,82,62,20,82,0.756,16.0,0.5625,2010
5,Byron Scott,CLE,1,11,82,19,63,82,19,63,789,0.47,57.0,0.5789473684210527,2010
6,Rick Carlisle,DAL,3,9,82,57,25,246,162,84,738,0.6,99.0,0.5353535353535354,2010
7,George Karl,DEN,7,23,82,50,32,532,328,204,1739,0.596,172.0,0.436046511627907,2010
8,John Kuester,DET,2,2,82,30,52,164,57,107,164,0.348,,,2010
9,Keith Smart,GSW,1,2,82,36,46,82,36,46,122,0.369,,,2010
10,Rick Adelman,HOU,4,20,82,43,39,328,193,135,1561,0.605,157.0,0.5031847133757962,2010
11,Jim O'Brien,IND,4,9,44,17,27,290,121,169,630,0.481,31.0,0.45161290322580644,2010
12,Frank Vogel,IND,1,1,38,20,18,38,20,18,38,0.526,5.0,0.2,2010
13,Vinny Del Negro,LAC,1,3,82,32,50,82,32,50,246,0.463,12.0,0.3333333333333333,2010
14,Phil Jackson,LAL,11,20,82,57,25,902,610,292,1640,0.704,333.0,0.6876876876876877,2010
15,Lionel Hollins,MEM,5,5,82,46,36,267,117,150,267,0.438,13.0,0.5384615384615384,2010
16,Erik Spoelstra,MIA,3,3,82,58,24,246,148,98,246,0.602,33.0,0.5454545454545454,2010
17,Scott Skiles,MIL,3,11,82,35,47,246,115,131,778,0.509,42.0,0.42857142857142855,2010
18,Kurt Rambis,MIN,2,3,82,17,65,164,32,132,201,0.279,8.0,0.375,2010
19,Avery Johnson,NJN,1,5,82,24,58,82,24,58,346,0.63,47.0,0.48936170212765956,2010
20,Monty Williams,NOH,1,1,82,46,36,82,46,36,82,0.561,6.0,0.3333333333333333,2010
21,Mike D'Antoni,NYK,3,9,82,42,40,246,103,143,685,0.54,55.0,0.4727272727272727,2010
22,Scott Brooks,OKC,3,3,82,55,27,233,127,106,233,0.545,23.0,0.4782608695652174,2010
23,Stan Van Gundy,ORL,4,7,82,52,30,328,222,106,513,0.651,82.0,0.573170731707317,2010
24,Doug Collins,PHI,1,9,82,41,41,82,41,41,701,0.532,43.0,0.37209302325581395,2010
25,Alvin Gentry,PHO,3,10,82,40,42,195,112,83,598,0.483,21.0,0.5714285714285714,2010
26,Nate McMillan,POR,6,11,82,48,34,492,246,246,887,0.516,34.0,0.4117647058823529,2010
27,Paul Westphal,SAC,2,9,82,24,58,164,49,115,590,0.536,49.0,0.5510204081632653,2010
28,Gregg Popovich,SAS,15,15,82,61,21,1180,797,383,1180,0.675,181.0,0.5966850828729282,2010
29,Jay Triano,TOR,3,3,82,22,60,229,87,142,229,0.38,,,2010
30,Jerry Sloan,UTA,23,26,54,31,23,1809,1127,682,2024,0.603,202.0,0.48514851485148514,2010
31,Tyrone Corbin,UTA,1,1,28,8,20,28,8,20,28,0.286,,,2010
32,Flip Saunders,WAS,2,15,82,23,59,164,49,115,1147,0.554,98.0,0.47959183673469385,2010
0,Larry Drew,ATL,2,2,66,40,26,148,84,64,148,0.568,18.0,0.4444444444444444,2011
1,Doc Rivers,BOS,8,13,66,39,27,640,375,265,979,0.558,115.0,0.5391304347826087,2011
2,Paul Silas,CHA,6,12,66,7,59,401,193,208,875,0.442,29.0,0.4482758620689655,2011
3,Tom Thibodeau,CHI,2,2,66,50,16,148,112,36,148,0.757,22.0,0.5,2011
4,Byron Scott,CLE,2,12,66,21,45,148,40,108,855,0.458,57.0,0.5789473684210527,2011
5,Rick Carlisle,DAL,4,10,66,36,30,312,198,114,804,0.596,103.0,0.5145631067961165,2011
6,George Karl,DEN,8,24,66,38,28,598,366,232,1805,0.595,179.0,0.43575418994413406,2011
7,Lawrence Frank,DET,1,8,66,25,41,66,25,41,532,0.47,38.0,0.47368421052631576,2011
8,Mark Jackson,GSW,1,1,66,23,43,66,23,43,66,0.348,,,2011
9,Kevin McHale,HOU,1,3,66,34,32,66,34,32,160,0.456,,,2011
10,Frank Vogel,IND,2,2,66,42,24,104,62,42,104,0.596,16.0,0.4375,2011
11,Vinny Del Negro,LAC,2,4,66,40,26,148,72,76,312,0.494,23.0,0.34782608695652173,2011
12,Mike Brown,LAL,1,6,66,41,25,66,41,25,476,0.658,83.0,0.5662650602409639,2011
13,Lionel Hollins,MEM,6,6,66,41,25,333,158,175,333,0.474,20.0,0.5,2011
14,Erik Spoelstra,MIA,4,4,66,46,20,312,194,118,312,0.622,56.0,0.6071428571428571,2011
15,Scott Skiles,MIL,4,12,66,31,35,312,146,166,844,0.506,42.0,0.42857142857142855,2011
16,Rick Adelman,MIN,1,21,66,26,40,66,26,40,1627,0.597,157.0,0.5031847133757962,2011
17,Avery Johnson,NJN,2,6,66,22,44,148,46,102,412,0.583,47.0,0.48936170212765956,2011
18,Monty Williams,NOH,2,2,66,21,45,148,67,81,148,0.453,6.0,0.3333333333333333,2011
19,Mike D'Antoni,NYK,4,10,42,18,24,288,121,167,727,0.534,55.0,0.4727272727272727,2011
20,Mike Woodson,NYK,1,7,24,18,6,24,18,6,516,0.434,34.0,0.35294117647058826,2011
21,Scott Brooks,OKC,4,4,66,47,19,299,174,125,299,0.582,43.0,0.5581395348837209,2011
22,Stan Van Gundy,ORL,5,8,66,37,29,394,259,135,579,0.641,87.0,0.5517241379310345,2011
23,Doug Collins,PHI,2,10,66,35,31,148,76,72,767,0.532,56.0,0.4107142857142857,2011
24,Alvin Gentry,PHO,4,11,66,33,33,261,145,116,664,0.485,21.0,0.5714285714285714,2011
25,Nate McMillan,POR,7,12,43,20,23,535,266,269,930,0.514,34.0,0.4117647058823529,2011
26,Kaleb Canales,POR,1,1,23,8,15,23,8,15,23,0.348,,,2011
27,Paul Westphal,SAC,3,10,7,2,5,171,51,120,597,0.533,49.0,0.5510204081632653,2011
28,Keith Smart,SAC,1,3,59,20,39,59,20,39,181,0.359,,,2011
29,Gregg Popovich,SAS,16,16,66,50,16,1246,847,399,1246,0.68,195.0,0.6051282051282051,2011
30,Dwane Casey,TOR,1,3,66,23,43,66,23,43,188,0.404,,,2011
31,Tyrone Corbin,UTA,2,2,66,36,30,94,44,50,94,0.468,4.0,0.0,2011
32,Flip Saunders,WAS,3,16,17,2,15,181,51,130,1164,0.548,98.0,0.47959183673469385,2011
33,Randy Wittman,WAS,1,6,49,18,31,49,18,31,356,0.331,,,2011
0,Larry Drew,ATL,3,3,82,44,38,230,128,102,230,0.557,24.0,0.4166666666666667,2012
1,Doc Rivers,BOS,9,14,81,41,40,721,416,305,1060,0.554,121.0,0.5289256198347108,2012
2,Avery Johnson,BRK,3,7,28,14,14,176,60,116,440,0.577,47.0,0.48936170212765956,2012
3,P.J. Carlesimo,BRK,1,9,54,35,19,54,35,19,554,0.431,19.0,0.3157894736842105,2012
4,Mike Dunlap,CHA,1,1,82,21,61,82,21,61,82,0.256,,,2012
5,Tom Thibodeau,CHI,3,3,82,45,37,230,157,73,230,0.683,34.0,0.47058823529411764,2012
6,Byron Scott,CLE,3,13,82,24,58,230,64,166,937,0.444,57.0,0.5789473684210527,2012
7,Rick Carlisle,DAL,5,11,82,41,41,394,239,155,886,0.587,103.0,0.5145631067961165,2012
8,George Karl,DEN,9,25,82,57,25,680,423,257,1887,0.599,185.0,0.43243243243243246,2012
9,Lawrence Frank,DET,2,9,82,29,53,148,54,94,614,0.454,38.0,0.47368421052631576,2012
10,Mark Jackson,GSW,2,2,82,47,35,148,70,78,148,0.473,12.0,0.5,2012
11,Kevin McHale,HOU,2,4,82,45,37,148,79,69,242,0.488,6.0,0.3333333333333333,2012
12,Frank Vogel,IND,3,3,81,49,32,185,111,74,185,0.6,35.0,0.5142857142857142,2012
13,Vinny Del Negro,LAC,3,5,82,56,26,230,128,102,394,0.533,29.0,0.3448275862068966,2012
14,Mike Brown,LAL,2,7,5,1,4,71,42,29,481,0.653,83.0,0.5662650602409639,2012
15,Bernie Bickerstaff,LAL,1,14,5,4,1,5,4,1,937,0.447,33.0,0.36363636363636365,2012
16,Mike D'Antoni,LAL,1,11,72,40,32,72,40,32,799,0.536,59.0,0.4406779661016949,2012
17,Lionel Hollins,MEM,7,7,82,56,26,415,214,201,415,0.516,35.0,0.5142857142857142,2012
18,Erik Spoelstra,MIA,5,5,82,66,16,394,260,134,394,0.66,79.0,0.6329113924050633,2012
19,Scott Skiles,MIL,5,13,32,16,16,344,162,182,876,0.506,42.0,0.42857142857142855,2012
20,Jim Boylan,MIL,1,2,50,22,28,50,22,28,106,0.434,4.0,0.0,2012
21,Rick Adelman,MIN,2,22,82,31,51,148,57,91,1709,0.586,157.0,0.5031847133757962,2012
22,Monty Williams,NOH,3,3,82,27,55,230,94,136,230,0.409,6.0,0.3333333333333333,2012
23,Mike Woodson,NYK,2,8,82,54,28,106,72,34,598,0.465,46.0,0.391304347826087,2012
24,Scott Brooks,OKC,5,5,82,60,22,381,234,147,381,0.614,54.0,0.5370370370370371,2012
25,Jacque Vaughn,ORL,1,1,82,20,62,82,20,62,82,0.244,,,2012
26,Doug Collins,PHI,3,11,82,34,48,230,110,120,849,0.521,56.0,0.4107142857142857,2012
27,Alvin Gentry,PHO,5,12,41,13,28,302,158,144,705,0.475,21.0,0.5714285714285714,2012
28,Lindsey Hunter,PHO,1,1,41,12,29,41,12,29,41,0.293,,,2012
29,Terry Stotts,POR,1,5,82,33,49,82,33,49,365,0.405,5.0,0.2,2012
30,Keith Smart,SAC,2,4,82,28,54,141,48,93,263,0.354,,,2012
31,Gregg Popovich,SAS,17,17,82,58,24,1328,905,423,1328,0.681,216.0,0.6157407407407407,2012
32,Dwane Casey,TOR,2,4,82,34,48,148,57,91,270,0.407,,,2012
33,Tyrone Corbin,UTA,3,3,82,43,39,176,87,89,176,0.494,4.0,0.0,2012
34,Randy Wittman,WAS,2,7,82,29,53,131,47,84,438,0.336,,,2012
0,Mike Budenholzer,ATL,1,1,82,38,44,82,38,44,82,0.463,7.0,0.42857142857142855,2013
1,Brad Stevens,BOS,1,1,82,25,57,82,25,57,82,0.305,,,2013
2,Jason Kidd,BRK,1,1,82,44,38,82,44,38,82,0.537,12.0,0.4166666666666667,2013
3,Steve Clifford,CHA,1,1,82,43,39,82,43,39,82,0.524,4.0,0.0,2013
4,Tom Thibodeau,CHI,4,4,82,48,34,312,205,107,312,0.657,39.0,0.4358974358974359,2013
5,Mike Brown,CLE,6,8,82,33,49,492,305,187,563,0.616,83.0,0.5662650602409639,2013
6,Rick Carlisle,DAL,6,12,82,49,33,476,288,188,968,0.588,110.0,0.509090909090909,2013
7,Brian Shaw,DEN,1,1,82,36,46,82,36,46,82,0.439,,,2013
8,Maurice Cheeks,DET,1,9,50,21,29,50,21,29,620,0.492,16.0,0.3125,2013
9,John Loyer,DET,1,1,32,8,24,32,8,24,32,0.25,,,2013
10,Mark Jackson,GSW,3,3,82,51,31,230,121,109,230,0.526,19.0,0.47368421052631576,2013
11,Kevin McHale,HOU,3,5,82,54,28,230,133,97,324,0.531,12.0,0.3333333333333333,2013
12,Frank Vogel,IND,4,4,82,56,26,267,167,100,267,0.625,54.0,0.5185185185185185,2013
13,Doc Rivers,LAC,1,15,82,57,25,82,57,25,1142,0.564,134.0,0.5223880597014925,2013
14,Mike D'Antoni,LAL,2,12,82,27,55,154,67,87,881,0.516,59.0,0.4406779661016949,2013
15,Dave Joerger,MEM,1,1,82,50,32,82,50,32,82,0.61,7.0,0.42857142857142855,2013
16,Erik Spoelstra,MIA,6,6,82,54,28,476,314,162,476,0.66,99.0,0.6363636363636364,2013
17,Larry Drew,MIL,1,4,82,15,67,82,15,67,312,0.458,24.0,0.4166666666666667,2013
18,Rick Adelman,MIN,3,23,82,40,42,230,97,133,1791,0.582,157.0,0.5031847133757962,2013
19,Monty Williams,NOP,4,4,82,34,48,312,128,184,312,0.41,6.0,0.3333333333333333,2013
20,Mike Woodson,NYK,3,9,82,37,45,188,109,79,680,0.463,46.0,0.391304347826087,2013
21,Scott Brooks,OKC,6,6,82,59,23,463,293,170,463,0.633,73.0,0.5342465753424658,2013
22,Jacque Vaughn,ORL,2,2,82,23,59,164,43,121,164,0.262,,,2013
23,Brett Brown,PHI,1,1,82,19,63,82,19,63,82,0.232,,,2013
24,Jeff Hornacek,PHO,1,1,82,48,34,82,48,34,82,0.585,,,2013
25,Terry Stotts,POR,2,6,82,54,28,164,87,77,447,0.452,16.0,0.375,2013
26,Michael Malone,SAC,1,1,82,28,54,82,28,54,82,0.341,,,2013
27,Gregg Popovich,SAS,18,18,82,62,20,1410,967,443,1410,0.686,239.0,0.6234309623430963,2013
28,Dwane Casey,TOR,3,5,82,48,34,230,105,125,352,0.449,7.0,0.42857142857142855,2013
29,Tyrone Corbin,UTA,4,4,82,25,57,258,112,146,258,0.434,4.0,0.0,2013
30,Randy Wittman,WAS,3,8,82,44,38,213,91,122,520,0.367,11.0,0.5454545454545454,2013
0,Mike Budenholzer,ATL,2,2,82,60,22,164,98,66,164,0.598,23.0,0.4782608695652174,2014
1,Brad Stevens,BOS,2,2,82,40,42,164,65,99,164,0.396,4.0,0.0,2014
2,Lionel Hollins,BRK,1,8,82,38,44,82,38,44,497,0.507,41.0,0.4878048780487805,2014
3,Tom Thibodeau,CHI,5,5,82,50,32,394,255,139,394,0.647,51.0,0.45098039215686275,2014
4,Steve Clifford,CHO,2,2,82,33,49,164,76,88,164,0.463,4.0,0.0,2014
5,David Blatt,CLE,1,1,82,53,29,82,53,29,82,0.646,20.0,0.7,2014
6,Rick Carlisle,DAL,7,13,82,50,32,558,338,220,1050,0.59,115.0,0.4956521739130435,2014
7,Brian Shaw,DEN,2,2,59,20,39,141,56,85,141,0.397,,,2014
8,Melvin Hunt,DEN,1,1,23,10,13,23,10,13,23,0.435,,,2014
9,Stan Van Gundy,DET,1,9,82,32,50,82,32,50,661,0.61,87.0,0.5517241379310345,2014
10,Steve Kerr,GSW,1,1,82,67,15,82,67,15,82,0.817,21.0,0.7619047619047619,2014
11,Kevin McHale,HOU,4,6,82,56,26,312,189,123,406,0.562,29.0,0.4482758620689655,2014
12,Frank Vogel,IND,5,5,82,38,44,349,205,144,349,0.587,54.0,0.5185185185185185,2014
13,Doc Rivers,LAC,2,16,82,56,26,164,113,51,1224,0.572,148.0,0.5202702702702703,2014
14,Byron Scott,LAL,1,14,82,21,61,82,21,61,1019,0.429,57.0,0.5789473684210527,2014
15,Dave Joerger,MEM,2,2,82,55,27,164,105,59,164,0.64,18.0,0.5,2014
16,Erik Spoelstra,MIA,7,7,82,37,45,558,351,207,558,0.629,99.0,0.6363636363636364,2014
17,Jason Kidd,MIL,1,2,82,41,41,82,41,41,164,0.518,18.0,0.3888888888888889,2014
18,Flip Saunders,MIN,11,17,82,16,66,819,427,392,1246,0.525,98.0,0.47959183673469385,2014
19,Monty Williams,NOP,5,5,82,45,37,394,173,221,394,0.439,10.0,0.2,2014
20,Derek Fisher,NYK,1,1,82,17,65,82,17,65,82,0.207,,,2014
21,Scott Brooks,OKC,7,7,82,45,37,545,338,207,545,0.62,73.0,0.5342465753424658,2014
22,Jacque Vaughn,ORL,3,3,52,15,37,216,58,158,216,0.269,,,2014
23,James Borrego,ORL,1,1,30,10,20,30,10,20,30,0.333,,,2014
24,Brett Brown,PHI,2,2,82,18,64,164,37,127,164,0.226,,,2014
25,Jeff Hornacek,PHO,2,2,82,39,43,164,87,77,164,0.53,,,2014
26,Terry Stotts,POR,3,7,82,51,31,246,138,108,529,0.478,21.0,0.3333333333333333,2014
27,Michael Malone,SAC,2,2,24,11,13,106,39,67,106,0.368,,,2014
28,Tyrone Corbin,SAC,1,5,28,7,21,28,7,21,286,0.416,4.0,0.0,2014
29,George Karl,SAC,1,26,30,11,19,30,11,19,1917,0.596,185.0,0.43243243243243246,2014
30,Gregg Popovich,SAS,19,19,82,55,27,1492,1022,470,1492,0.685,246.0,0.6178861788617886,2014
31,Dwane Casey,TOR,4,6,82,49,33,312,154,158,434,0.477,11.0,0.2727272727272727,2014
32,Quin Snyder,UTA,1,1,82,38,44,82,38,44,82,0.463,,,2014
33,Randy Wittman,WAS,4,9,82,46,36,295,137,158,602,0.394,21.0,0.5714285714285714,2014
0,Mike Budenholzer,ATL,3,3,82,48,34,246,146,100,246,0.593,33.0,0.45454545454545453,2015
1,Brad Stevens,BOS,3,3,82,48,34,246,113,133,246,0.459,10.0,0.2,2015
2,Lionel Hollins,BRK,2,9,37,10,27,119,48,71,534,0.491,41.0,0.4878048780487805,2015
3,Tony Brown,BRK,1,1,45,11,34,45,11,34,45,0.244,,,2015
4,Fred Hoiberg,CHI,1,1,82,42,40,82,42,40,82,0.512,,,2015
5,Steve Clifford,CHO,3,3,82,48,34,246,124,122,246,0.504,11.0,0.2727272727272727,2015
6,David Blatt,CLE,2,2,41,30,11,123,83,40,123,0.675,20.0,0.7,2015
7,Tyronn Lue,CLE,1,1,41,27,14,41,27,14,41,0.659,21.0,0.7619047619047619,2015
8,Rick Carlisle,DAL,8,14,82,42,40,640,380,260,1132,0.584,120.0,0.48333333333333334,2015
9,Michael Malone,DEN,1,3,82,33,49,82,33,49,188,0.383,,,2015
10,Stan Van Gundy,DET,2,10,82,44,38,164,76,88,743,0.602,91.0,0.5274725274725275,2015
11,Steve Kerr,GSW,2,2,82,73,9,164,140,24,164,0.854,45.0,0.6888888888888889,2015
12,Kevin McHale,HOU,5,7,11,4,7,323,193,130,417,0.556,29.0,0.4482758620689655,2015
13,J.B. Bickerstaff,HOU,1,1,71,37,34,71,37,34,71,0.521,5.0,0.2,2015
14,Frank Vogel,IND,6,6,82,45,37,431,250,181,431,0.58,61.0,0.5081967213114754,2015
15,Doc Rivers,LAC,3,17,82,53,29,246,166,80,1306,0.577,154.0,0.512987012987013,2015
16,Byron Scott,LAL,2,15,82,17,65,164,38,126,1101,0.412,57.0,0.5789473684210527,2015
17,Dave Joerger,MEM,3,3,82,42,40,246,147,99,246,0.598,22.0,0.4090909090909091,2015
18,Erik Spoelstra,MIA,8,8,82,48,34,640,399,241,640,0.623,113.0,0.6194690265486725,2015
19,Jason Kidd,MIL,2,3,82,33,49,164,74,90,246,0.48,18.0,0.3888888888888889,2015
20,Sam Mitchell,MIN,1,6,82,29,53,82,29,53,427,0.433,11.0,0.2727272727272727,2015
21,Alvin Gentry,NOP,1,13,82,30,52,82,30,52,787,0.464,21.0,0.5714285714285714,2015
22,Derek Fisher,NYK,2,2,54,23,31,136,40,96,136,0.294,,,2015
23,Kurt Rambis,NYK,1,4,28,9,19,28,9,19,229,0.284,8.0,0.375,2015
24,Billy Donovan,OKC,1,1,82,55,27,82,55,27,82,0.671,18.0,0.6111111111111112,2015
25,Scott Skiles,ORL,1,14,82,35,47,82,35,47,958,0.499,42.0,0.42857142857142855,2015
26,Brett Brown,PHI,3,3,82,10,72,246,47,199,246,0.191,,,2015
27,Jeff Hornacek,PHO,3,3,49,14,35,213,101,112,213,0.474,,,2015
28,Earl Watson,PHO,1,1,33,9,24,33,9,24,33,0.273,,,2015
29,Terry Stotts,POR,4,8,82,44,38,328,182,146,611,0.486,32.0,0.375,2015
30,George Karl,SAC,2,27,82,33,49,112,44,68,1999,0.588,185.0,0.43243243243243246,2015
31,Gregg Popovich,SAS,20,20,82,67,15,1574,1089,485,1574,0.692,256.0,0.6171875,2015
32,Dwane Casey,TOR,5,7,82,56,26,394,210,184,516,0.51,31.0,0.41935483870967744,2015
33,Quin Snyder,UTA,2,2,82,40,42,164,78,86,164,0.476,,,2015
34,Randy Wittman,WAS,5,10,82,41,41,377,178,199,684,0.406,21.0,0.5714285714285714,2015
0,Mike Budenholzer,ATL,4,4,82,43,39,328,189,139,328,0.576,39.0,0.4358974358974359,2016
1,Brad Stevens,BOS,4,4,82,53,29,328,166,162,328,0.506,28.0,0.39285714285714285,2016
2,Kenny Atkinson,BRK,1,1,82,20,62,82,20,62,82,0.244,,,2016
3,Fred Hoiberg,CHI,2,2,82,41,41,164,83,81,164,0.506,6.0,0.3333333333333333,2016
4,Steve Clifford,CHO,4,4,82,36,46,328,160,168,328,0.488,11.0,0.2727272727272727,2016
5,Tyronn Lue,CLE,2,2,82,51,31,123,78,45,123,0.634,39.0,0.7435897435897436,2016
6,Rick Carlisle,DAL,9,15,82,33,49,722,413,309,1214,0.572,120.0,0.48333333333333334,2016
7,Michael Malone,DEN,2,4,82,40,42,164,73,91,270,0.415,,,2016
8,Stan Van Gundy,DET,3,11,82,37,45,246,113,133,825,0.587,91.0,0.5274725274725275,2016
9,Steve Kerr,GSW,3,3,82,67,15,246,207,39,246,0.841,62.0,0.7580645161290323,2016
10,Mike D'Antoni,HOU,1,13,82,55,27,82,55,27,963,0.53,70.0,0.45714285714285713,2016
11,Nate McMillan,IND,1,13,82,42,40,82,42,40,1012,0.514,38.0,0.3684210526315789,2016
12,Doc Rivers,LAC,4,18,82,51,31,328,217,111,1388,0.579,161.0,0.5093167701863354,2016
13,Luke Walton,LAL,1,1,82,26,56,82,26,56,82,0.317,,,2016
14,David Fizdale,MEM,1,1,82,43,39,82,43,39,82,0.524,6.0,0.3333333333333333,2016
15,Erik Spoelstra,MIA,9,9,82,41,41,722,440,282,722,0.609,113.0,0.6194690265486725,2016
16,Jason Kidd,MIL,3,4,82,42,40,246,116,130,328,0.488,24.0,0.375,2016
17,Tom Thibodeau,MIN,1,6,82,31,51,82,31,51,476,0.601,51.0,0.45098039215686275,2016
18,Alvin Gentry,NOP,2,14,82,34,48,164,64,100,869,0.459,21.0,0.5714285714285714,2016
19,Jeff Hornacek,NYK,1,4,82,31,51,82,31,51,295,0.447,,,2016
20,Billy Donovan,OKC,2,2,82,47,35,164,102,62,164,0.622,23.0,0.5217391304347826,2016
21,Frank Vogel,ORL,1,7,82,29,53,82,29,53,513,0.544,61.0,0.5081967213114754,2016
22,Brett Brown,PHI,4,4,82,28,54,328,75,253,328,0.229,,,2016
23,Earl Watson,PHO,2,2,82,24,58,115,33,82,115,0.287,,,2016
24,Terry Stotts,POR,5,9,82,41,41,410,223,187,693,0.488,36.0,0.3333333333333333,2016
25,Dave Joerger,SAC,1,4,82,32,50,82,32,50,328,0.546,22.0,0.4090909090909091,2016
26,Gregg Popovich,SAS,21,21,82,61,21,1656,1150,506,1656,0.694,272.0,0.6102941176470589,2016
27,Dwane Casey,TOR,6,8,82,51,31,476,261,215,598,0.525,41.0,0.4146341463414634,2016
28,Quin Snyder,UTA,3,3,82,51,31,246,129,117,246,0.524,11.0,0.36363636363636365,2016
29,Scott Brooks,WAS,1,8,82,49,33,82,49,33,627,0.617,86.0,0.5348837209302325,2016
0,Mike Budenholzer,ATL,5,5,82,24,58,410,213,197,410,0.52,39.0,0.4358974358974359,2017
1,Brad Stevens,BOS,5,5,82,55,27,410,221,189,410,0.539,47.0,0.46808510638297873,2017
2,Kenny Atkinson,BRK,2,2,82,28,54,164,48,116,164,0.293,,,2017
3,Fred Hoiberg,CHI,3,3,82,27,55,246,110,136,246,0.447,6.0,0.3333333333333333,2017
4,Steve Clifford,CHO,5,5,82,36,46,410,196,214,410,0.478,11.0,0.2727272727272727,2017
5,Tyronn Lue,CLE,3,3,82,50,32,205,128,77,205,0.624,61.0,0.6721311475409836,2017
6,Rick Carlisle,DAL,10,16,82,24,58,804,437,367,1296,0.554,120.0,0.48333333333333334,2017
7,Michael Malone,DEN,3,5,82,46,36,246,119,127,352,0.449,,,2017
8,Stan Van Gundy,DET,4,12,82,39,43,328,152,176,907,0.577,91.0,0.5274725274725275,2017
9,Steve Kerr,GSW,4,4,82,58,24,328,265,63,328,0.808,83.0,0.7590361445783133,2017
10,Mike D'Antoni,HOU,2,14,82,65,17,164,120,44,1045,0.55,87.0,0.4942528735632184,2017
11,Nate McMillan,IND,2,14,82,48,34,164,90,74,1094,0.519,45.0,0.37777777777777777,2017
12,Doc Rivers,LAC,5,19,82,42,40,410,259,151,1470,0.576,161.0,0.5093167701863354,2017
13,Luke Walton,LAL,2,2,82,35,47,164,61,103,164,0.372,,,2017
14,David Fizdale,MEM,2,2,19,7,12,101,50,51,101,0.495,6.0,0.3333333333333333,2017
15,J.B. Bickerstaff,MEM,1,2,63,15,48,63,15,48,134,0.388,5.0,0.2,2017
16,Erik Spoelstra,MIA,10,10,82,44,38,804,484,320,804,0.602,118.0,0.6016949152542372,2017
17,Jason Kidd,MIL,4,5,45,23,22,291,139,152,373,0.491,24.0,0.375,2017
18,Joe Prunty,MIL,1,1,37,21,16,37,21,16,37,0.568,7.0,0.42857142857142855,2017
19,Tom Thibodeau,MIN,2,7,82,47,35,164,78,86,558,0.597,56.0,0.42857142857142855,2017
20,Alvin Gentry,NOP,3,15,82,48,34,246,112,134,951,0.47,30.0,0.5666666666666667,2017
21,Jeff Hornacek,NYK,2,5,82,29,53,164,60,104,377,0.427,,,2017
22,Billy Donovan,OKC,3,3,82,48,34,246,150,96,246,0.61,29.0,0.4827586206896552,2017
23,Frank Vogel,ORL,2,8,82,25,57,164,54,110,595,0.511,61.0,0.5081967213114754,2017
24,Brett Brown,PHI,5,5,82,52,30,410,127,283,410,0.31,10.0,0.5,2017
25,Earl Watson,PHO,3,3,3,0,3,118,33,85,118,0.28,,,2017
26,Jay Triano,PHO,1,4,79,21,58,79,21,58,308,0.351,,,2017
27,Terry Stotts,POR,6,10,82,49,33,492,272,220,775,0.499,40.0,0.3,2017
28,Dave Joerger,SAC,2,5,82,27,55,164,59,105,410,0.502,22.0,0.4090909090909091,2017
29,Gregg Popovich,SAS,22,22,82,47,35,1738,1197,541,1738,0.689,277.0,0.6028880866425993,2017
30,Dwane Casey,TOR,7,9,82,59,23,558,320,238,680,0.549,51.0,0.4117647058823529,2017
31,Quin Snyder,UTA,4,4,82,48,34,328,177,151,328,0.54,22.0,0.4090909090909091,2017
32,Scott Brooks,WAS,2,9,82,43,39,164,92,72,709,0.606,92.0,0.5217391304347826,2017
0,Lloyd Pierce,ATL,1,1,82,29,53,82,29,53,82,0.354,,,2018
1,Brad Stevens,BOS,6,6,82,49,33,492,270,222,492,0.549,56.0,0.48214285714285715,2018
2,Kenny Atkinson,BRK,3,3,82,42,40,246,90,156,246,0.366,5.0,0.2,2018
3,Fred Hoiberg,CHI,4,4,24,5,19,270,115,155,270,0.426,6.0,0.3333333333333333,2018
4,Jim Boylen,CHI,1,1,58,17,41,58,17,41,58,0.293,,,2018
5,James Borrego,CHO,1,2,82,39,43,82,39,43,112,0.438,,,2018
6,Tyronn Lue,CLE,4,4,6,0,6,211,128,83,211,0.607,61.0,0.6721311475409836,2018
7,Larry Drew,CLE,1,5,76,19,57,76,19,57,388,0.418,24.0,0.4166666666666667,2018
8,Rick Carlisle,DAL,11,17,82,33,49,886,470,416,1378,0.545,120.0,0.48333333333333334,2018
9,Michael Malone,DEN,4,6,82,54,28,328,173,155,434,0.488,14.0,0.5,2018
10,Dwane Casey,DET,1,10,82,41,41,82,41,41,762,0.543,55.0,0.38181818181818183,2018
11,Steve Kerr,GSW,5,5,82,57,25,410,322,88,410,0.785,105.0,0.7333333333333333,2018
12,Mike D'Antoni,HOU,3,15,82,53,29,246,173,73,1127,0.557,98.0,0.5,2018
13,Nate McMillan,IND,3,15,82,48,34,246,138,108,1176,0.524,49.0,0.3469387755102041,2018
14,Doc Rivers,LAC,6,20,82,48,34,492,307,185,1552,0.576,167.0,0.5029940119760479,2018
15,Luke Walton,LAL,3,3,82,37,45,246,98,148,246,0.398,,,2018
16,J.B. Bickerstaff,MEM,2,3,82,33,49,145,48,97,216,0.394,5.0,0.2,2018
17,Erik Spoelstra,MIA,11,11,82,39,43,886,523,363,886,0.59,118.0,0.6016949152542372,2018
18,Mike Budenholzer,MIL,1,6,82,60,22,82,60,22,492,0.555,54.0,0.5,2018
19,Tom Thibodeau,MIN,3,8,40,19,21,204,97,107,598,0.589,56.0,0.42857142857142855,2018
20,Ryan Saunders,MIN,1,1,42,17,25,42,17,25,42,0.405,,,2018
21,Alvin Gentry,NOP,4,16,82,33,49,328,145,183,1033,0.465,30.0,0.5666666666666667,2018
22,David Fizdale,NYK,1,3,82,17,65,82,17,65,183,0.366,6.0,0.3333333333333333,2018
23,Billy Donovan,OKC,4,4,82,49,33,328,199,129,328,0.607,34.0,0.4411764705882353,2018
24,Steve Clifford,ORL,1,6,82,42,40,82,42,40,492,0.484,16.0,0.25,2018
25,Brett Brown,PHI,6,6,82,51,31,492,178,314,492,0.362,22.0,0.5454545454545454,2018
26,Igor Kokoskov,PHO,1,1,82,19,63,82,19,63,82,0.232,,,2018
27,Terry Stotts,POR,7,11,82,53,29,574,325,249,857,0.513,56.0,0.35714285714285715,2018
28,Dave Joerger,SAC,3,6,82,39,43,246,98,148,492,0.498,22.0,0.4090909090909091,2018
29,Gregg Popovich,SAS,23,23,82,48,34,1820,1245,575,1820,0.684,284.0,0.5985915492957746,2018
30,Nick Nurse,TOR,1,1,82,58,24,82,58,24,82,0.707,24.0,0.6666666666666666,2018
31,Quin Snyder,UTA,5,5,82,50,32,410,227,183,410,0.554,27.0,0.37037037037037035,2018
32,Scott Brooks,WAS,3,10,82,32,50,246,124,122,791,0.584,92.0,0.5217391304347826,2018
0,Lloyd Pierce,ATL,2,2,67,20,47,149,49,100,149,0.329,,,2019
1,Brad Stevens,BOS,7,7,72,48,24,564,318,246,564,0.564,73.0,0.5068493150684932,2019
2,Kenny Atkinson,BRK,4,4,62,28,34,308,118,190,308,0.383,5.0,0.2,2019
3,Jacque Vaughn,BRK,1,4,10,7,3,10,7,3,226,0.288,4.0,0.0,2019
4,Jim Boylen,CHI,2,2,65,22,43,123,39,84,123,0.317,,,2019
5,James Borrego,CHO,2,3,65,23,42,147,62,85,177,0.407,,,2019
6,John Beilein,CLE,1,1,54,14,40,54,14,40,54,0.259,,,2019
7,J.B. Bickerstaff,CLE,1,4,11,5,6,11,5,6,227,0.396,5.0,0.2,2019
8,Rick Carlisle,DAL,12,18,75,43,32,961,513,448,1453,0.546,126.0,0.47619047619047616,2019
9,Michael Malone,DEN,5,7,73,46,27,401,219,182,507,0.509,33.0,0.48484848484848486,2019
10,Dwane Casey,DET,2,11,66,20,46,148,61,87,828,0.524,55.0,0.38181818181818183,2019
11,Steve Kerr,GSW,6,6,65,15,50,475,337,138,475,0.709,105.0,0.7333333333333333,2019
12,Mike D'Antoni,HOU,4,16,72,44,28,318,217,101,1199,0.56,110.0,0.4909090909090909,2019
13,Nate McMillan,IND,4,16,73,45,28,319,183,136,1249,0.529,53.0,0.32075471698113206,2019
14,Doc Rivers,LAC,7,21,72,49,23,564,356,208,1624,0.581,180.0,0.5055555555555555,2019
15,Frank Vogel,LAL,1,9,71,52,19,71,52,19,666,0.535,82.0,0.573170731707317,2019
16,Taylor Jenkins,MEM,1,1,73,34,39,73,34,39,73,0.466,,,2019
17,Erik Spoelstra,MIA,12,12,73,44,29,959,567,392,959,0.591,139.0,0.6115107913669064,2019
18,Mike Budenholzer,MIL,2,7,73,56,17,155,116,39,565,0.582,64.0,0.5,2019
19,Ryan Saunders,MIN,2,2,64,19,45,106,36,70,106,0.34,,,2019
20,Alvin Gentry,NOP,5,17,72,30,42,400,175,225,1105,0.462,30.0,0.5666666666666667,2019
21,David Fizdale,NYK,2,4,22,4,18,104,21,83,205,0.346,6.0,0.3333333333333333,2019
22,Mike Miller,NYK,1,1,44,17,27,44,17,27,44,0.386,,,2019
23,Billy Donovan,OKC,5,5,72,44,28,400,243,157,400,0.608,41.0,0.43902439024390244,2019
24,Steve Clifford,ORL,2,7,73,33,40,155,75,80,565,0.48,21.0,0.23809523809523808,2019
25,Brett Brown,PHI,7,7,73,43,30,565,221,344,565,0.391,26.0,0.46153846153846156,2019
26,Monty Williams,PHO,1,6,73,34,39,73,34,39,467,0.443,10.0,0.2,2019
27,Terry Stotts,POR,8,12,74,35,39,648,360,288,931,0.51,61.0,0.3442622950819672,2019
28,Luke Walton,SAC,1,4,72,31,41,72,31,41,318,0.406,,,2019
29,Gregg Popovich,SAS,24,24,71,32,39,1891,1277,614,1891,0.675,284.0,0.5985915492957746,2019
30,Nick Nurse,TOR,2,2,72,53,19,154,111,43,154,0.721,35.0,0.6571428571428571,2019
31,Quin Snyder,UTA,6,6,72,44,28,482,271,211,482,0.562,34.0,0.38235294117647056,2019
32,Scott Brooks,WAS,4,11,72,25,47,318,149,169,863,0.564,92.0,0.5217391304347826,2019
0,Lloyd Pierce,ATL,3,3,34,14,20,183,63,120,183,0.344,,,2020
1,Nate McMillan,ATL,1,17,38,27,11,38,27,11,1287,0.535,71.0,0.38028169014084506,2020
2,Brad Stevens,BOS,8,8,72,36,36,636,354,282,636,0.557,78.0,0.48717948717948717,2020
3,Steve Nash,BRK,1,1,72,48,24,72,48,24,72,0.667,12.0,0.5833333333333334,2020
4,Billy Donovan,CHI,1,6,72,31,41,72,31,41,472,0.581,41.0,0.43902439024390244,2020
5,James Borrego,CHO,3,4,72,33,39,219,95,124,249,0.422,,,2020
6,J.B. Bickerstaff,CLE,2,5,72,22,50,83,27,56,299,0.375,5.0,0.2,2020
7,Rick Carlisle,DAL,13,19,72,42,30,1033,555,478,1525,0.548,133.0,0.47368421052631576,2020
8,Michael Malone,DEN,6,8,72,47,25,473,266,207,579,0.527,43.0,0.46511627906976744,2020
9,Dwane Casey,DET,3,12,72,20,52,220,81,139,900,0.504,55.0,0.38181818181818183,2020
10,Steve Kerr,GSW,7,7,72,39,33,547,376,171,547,0.687,105.0,0.7333333333333333,2020
11,Stephen Silas,HOU,1,1,72,17,55,72,17,55,72,0.236,,,2020
12,Nate Bjorkgren,IND,1,1,72,34,38,72,34,38,72,0.472,,,2020
13,Tyronn Lue,LAC,1,5,72,47,25,72,47,25,283,0.618,80.0,0.6375,2020
14,Frank Vogel,LAL,2,10,72,42,30,143,94,49,738,0.539,88.0,0.5568181818181818,2020
15,Taylor Jenkins,MEM,2,2,72,38,34,145,72,73,145,0.497,5.0,0.2,2020
16,Erik Spoelstra,MIA,13,13,72,40,32,1031,607,424,1031,0.589,143.0,0.5944055944055944,2020
17,Mike Budenholzer,MIL,3,8,72,46,26,227,162,65,637,0.589,87.0,0.5517241379310345,2020
18,Ryan Saunders,MIN,3,3,31,7,24,137,43,94,137,0.314,,,2020
19,Chris Finch,MIN,1,1,41,16,25,41,16,25,41,0.39,,,2020
20,Stan Van Gundy,NOP,1,13,72,31,41,72,31,41,979,0.566,91.0,0.5274725274725275,2020
21,Tom Thibodeau,NYK,1,9,72,41,31,72,41,31,670,0.587,61.0,0.4098360655737705,2020
22,Mark Daigneault,OKC,1,1,72,22,50,72,22,50,72,0.306,,,2020
23,Steve Clifford,ORL,3,8,72,21,51,227,96,131,637,0.458,21.0,0.23809523809523808,2020
24,Doc Rivers,PHI,1,22,72,49,23,72,49,23,1696,0.585,192.0,0.5104166666666666,2020
25,Monty Williams,PHO,2,7,72,51,21,145,85,60,539,0.479,32.0,0.5,2020
26,Terry Stotts,POR,9,13,72,42,30,720,402,318,1003,0.515,67.0,0.34328358208955223,2020
27,Luke Walton,SAC,2,5,72,31,41,144,62,82,390,0.41,,,2020
28,Gregg Popovich,SAS,25,25,72,33,39,1963,1310,653,1963,0.667,284.0,0.5985915492957746,2020
29,Nick Nurse,TOR,3,3,72,27,45,226,138,88,226,0.611,35.0,0.6571428571428571,2020
30,Quin Snyder,UTA,7,7,72,52,20,554,323,231,554,0.583,45.0,0.4222222222222222,2020
31,Scott Brooks,WAS,5,12,72,34,38,390,183,207,935,0.557,97.0,0.5051546391752577,2020
0,Nate McMillan,ATL,2,18,82,43,39,120,70,50,1369,0.534,76.0,0.3684210526315789,2021
1,Ime Udoka,BOS,1,1,82,51,31,82,51,31,82,0.622,24.0,0.5833333333333334,2021
2,Steve Nash,BRK,2,2,82,44,38,154,92,62,154,0.597,16.0,0.4375,2021
3,Billy Donovan,CHI,2,7,82,46,36,154,77,77,554,0.578,46.0,0.41304347826086957,2021
4,James Borrego,CHO,4,5,82,43,39,301,138,163,331,0.447,,,2021
5,J.B. Bickerstaff,CLE,3,6,82,44,38,165,71,94,381,0.409,5.0,0.2,2021
6,Jason Kidd,DAL,1,6,82,52,30,82,52,30,455,0.516,42.0,0.42857142857142855,2021
7,Michael Malone,DEN,7,9,82,48,34,555,314,241,661,0.534,48.0,0.4375,2021
8,Dwane Casey,DET,4,13,82,23,59,302,104,198,982,0.486,55.0,0.38181818181818183,2021
9,Steve Kerr,GSW,8,8,82,53,29,629,429,200,629,0.682,127.0,0.7322834645669292,2021
10,Stephen Silas,HOU,2,2,82,20,62,154,37,117,154,0.24,,,2021
11,Rick Carlisle,IND,5,20,82,25,57,410,206,204,1607,0.536,133.0,0.47368421052631576,2021
12,Tyronn Lue,LAC,2,6,82,42,40,154,89,65,365,0.595,80.0,0.6375,2021
13,Frank Vogel,LAL,3,11,82,33,49,225,127,98,820,0.526,88.0,0.5568181818181818,2021
14,Taylor Jenkins,MEM,3,3,82,56,26,227,128,99,227,0.564,17.0,0.4117647058823529,2021
15,Erik Spoelstra,MIA,14,14,82,53,29,1113,660,453,1113,0.593,161.0,0.5962732919254659,2021
16,Mike Budenholzer,MIL,4,9,82,51,31,309,213,96,719,0.592,99.0,0.5555555555555556,2021
17,Chris Finch,MIN,2,2,82,46,36,123,62,61,123,0.504,6.0,0.3333333333333333,2021
18,Willie Green,NOP,1,1,82,36,46,82,36,46,82,0.439,6.0,0.3333333333333333,2021
19,Tom Thibodeau,NYK,2,10,82,37,45,154,78,76,752,0.572,61.0,0.4098360655737705,2021
20,Mark Daigneault,OKC,2,2,82,24,58,154,46,108,154,0.299,,,2021
21,Jamahl Mosley,ORL,1,1,82,22,60,82,22,60,82,0.268,,,2021
22,Doc Rivers,PHI,2,23,82,51,31,154,100,54,1778,0.587,204.0,0.5098039215686274,2021
23,Monty Williams,PHO,3,8,82,64,18,227,149,78,621,0.519,45.0,0.5111111111111111,2021
24,Chauncey Billups,POR,1,1,82,27,55,82,27,55,82,0.329,,,2021
25,Luke Walton,SAC,3,6,17,6,11,161,68,93,407,0.408,,,2021
26,Alvin Gentry,SAC,1,18,65,24,41,65,24,41,1170,0.456,30.0,0.5666666666666667,2021
27,Gregg Popovich,SAS,26,26,82,34,48,2045,1344,701,2045,0.657,284.0,0.5985915492957746,2021
28,Nick Nurse,TOR,4,4,82,48,34,308,186,122,308,0.604,41.0,0.6097560975609756,2021
29,Quin Snyder,UTA,8,8,82,49,33,636,372,264,636,0.585,51.0,0.4117647058823529,2021
30,Wes Unseld,WAS,1,1,82,35,47,82,35,47,82,0.427,,,2021
0,Nate McMillan,ATL,3,19,59,29,30,179,99,80,1428,0.532,76.0,0.3684210526315789,2022
1,Joe Prunty,ATL,1,2,2,2,0,2,2,0,39,0.59,7.0,0.42857142857142855,2022
2,Quin Snyder,ATL,1,9,21,10,11,21,10,11,657,0.581,57.0,0.40350877192982454,2022
3,Joe Mazzulla,BOS,1,1,82,57,25,82,57,25,82,0.695,20.0,0.55,2022
4,Steve Nash,BRK,3,3,7,2,5,161,94,67,161,0.584,16.0,0.4375,2022
5,Jacque Vaughn,BRK,2,5,75,43,32,85,50,35,301,0.359,8.0,0.0,2022
6,Billy Donovan,CHI,3,8,82,40,42,236,117,119,636,0.566,46.0,0.41304347826086957,2022
7,Steve Clifford,CHO,6,9,82,27,55,492,223,269,719,0.444,21.0,0.23809523809523808,2022
8,J.B. Bickerstaff,CLE,4,7,82,51,31,247,122,125,463,0.447,10.0,0.2,2022
9,Jason Kidd,DAL,2,7,82,38,44,164,90,74,537,0.508,42.0,0.42857142857142855,2022
10,Michael Malone,DEN,8,10,82,53,29,637,367,270,743,0.546,68.0,0.5441176470588235,2022
11,Dwane Casey,DET,5,14,82,17,65,384,121,263,1064,0.464,55.0,0.38181818181818183,2022
12,Steve Kerr,GSW,9,9,82,44,38,711,473,238,711,0.665,140.0,0.7071428571428572,2022
13,Stephen Silas,HOU,3,3,82,22,60,236,59,177,236,0.25,,,2022
14,Rick Carlisle,IND,6,21,82,35,47,492,241,251,1689,0.53,133.0,0.47368421052631576,2022
15,Tyronn Lue,LAC,3,7,82,44,38,236,133,103,447,0.584,85.0,0.611764705882353,2022
16,Darvin Ham,LAL,1,1,82,43,39,82,43,39,82,0.524,16.0,0.5,2022
17,Taylor Jenkins,MEM,4,4,82,51,31,309,179,130,309,0.579,23.0,0.391304347826087,2022
18,Erik Spoelstra,MIA,15,15,82,44,38,1195,704,491,1195,0.589,184.0,0.592391304347826,2022
19,Mike Budenholzer,MIL,5,10,82,58,24,391,271,120,801,0.604,104.0,0.5384615384615384,2022
20,Chris Finch,MIN,3,3,82,42,40,205,104,101,205,0.507,11.0,0.2727272727272727,2022
21,Willie Green,NOP,2,2,82,42,40,164,78,86,164,0.476,6.0,0.3333333333333333,2022
22,Tom Thibodeau,NYK,3,11,82,47,35,236,125,111,834,0.572,72.0,0.4305555555555556,2022
23,Mark Daigneault,OKC,3,3,82,40,42,236,86,150,236,0.364,,,2022
24,Jamahl Mosley,ORL,2,2,82,34,48,164,56,108,164,0.341,,,2022
25,Doc Rivers,PHI,3,24,82,54,28,236,154,82,1860,0.59,215.0,0.5162790697674419,2022
26,Monty Williams,PHO,4,9,82,45,37,309,194,115,703,0.522,56.0,0.5178571428571429,2022
27,Chauncey Billups,POR,2,2,82,33,49,164,60,104,164,0.366,,,2022
28,Mike Brown,SAC,1,9,82,48,34,82,48,34,645,0.612,90.0,0.5555555555555556,2022
29,Gregg Popovich,SAS,27,27,82,22,60,2127,1366,761,2127,0.642,284.0,0.5985915492957746,2022
30,Nick Nurse,TOR,5,5,82,41,41,390,227,163,390,0.582,41.0,0.6097560975609756,2022
31,Will Hardy,UTA,1,1,82,37,45,82,37,45,82,0.451,,,2022
32,Wes Unseld,WAS,2,2,82,35,47,164,70,94,164,0.427,,,2022
